You wake up in the morning and you are in your bedroom, but your magic powers are gone! Uh Oh...

Rainbow Dave's Journey
An Interactive Fiction by Liam Calahan
Release 1 / Serial number 220224 / Inform 7 build 6M62 (I6/v6.34 lib 6/12N) SD

Dave's Bedroom
You are in a small bedroom with a bed and a closet. To your south is the exit.

You can see a Closet (closed) here.

>go south
Hallway Outside Dave's Room
You are in a hallway. To your north is a door labeled "Dave's room", Room 201, and to your east and west the hallway continues.

>west
Hallway Outside Room 200
You are in a hallway. To your north is a door labeled "Sylvia's room", Room 200, and to your east there is a hallway, and to your west there is an elevator.

>north
Sylvia's Room
You are in a pink bedroom with a bed and a closet, and an oven that smells like chocolate cake. To your south is the exit.

Sylvia is snoring loudly on the bed.

>look at sylvia
Upon closer examination, Sylvia seems to be dreaming about chocolate cake.

* * *

You wake up in the morning and you are in your bedroom, but your magic powers are gone! Uh Oh...

Rainbow Dave's Journey
An Interactive Fiction by Liam Calahan
Release 1 / Serial number 220224 / Inform 7 build 6M62 (I6/v6.34 lib 6/12N) SD

Dave's Bedroom
You are in a small bedroom with a bed and a closet. To your south is the exit.

You can see a Closet (closed) here.

>go to bukshelv cliff
You can't see any such thing.

>s
(first opening Dave's door)

Hallway Outside Dave's Room
You are in a hallway. To your north is a door labeled "Dave's room", Room 201, and to your east and west the hallway continues.

>e
Hallway Outside Room 202
You are in a hallway. To your north is a door labeled "Swimmy's Room", Room 202, and to your west there is a hallway.

>n
(first opening Swimmy's door)

Swimmy's room
You are in a bedroom with ocean wallpaper, a bed, a couch, and a bunch of tools on top of a desk.

Swimmy is sitting on the couch reading a book.

>talk
(to Swimmy)
(Swimmy) Hi Dave, what is it?
(You) I lost my magic powers this morning.
(Swimmy) Oh no!
He pauses and looks something up on his computer.
(Swimmy) Apparently you can get them back, you just need to find 4 magic crystals! Maybe you can find them. Look around!

>s
Hallway Outside Room 202
You are in a hallway. To your north is a door labeled "Swimmy's Room", Room 202, and to your west there is a hallway.

>w
Hallway Outside Dave's Room
You are in a hallway. To your north is a door labeled "Dave's room", Room 201, and to your east and west the hallway continues.

>w
Hallway Outside Room 200
You are in a hallway. To your north is a door labeled "Sylvia's room", Room 200, and to your east there is a hallway, and to your west there is an elevator.

>w
Elevator Floor 2
You are in an elevator room. The elevator can go up or down. To your east is a hallway.

>d
Elevator Floor 1
You are in an elevator room. The elevator can go up but not down. To your east is a hallway, and to your south is a door labeled "Commons".

>s
Commons
You are in a nicely furnished room with a fireplace and some couches and books on the shelf. To your north is the elevator, and to your east is the lobby.

I beg your pardon?

>e
Lobby
You are in a entrance lobby. To your west is the commons, and to your south is the exit into the land of Lhivhingrum.

>s
North Plains of Car Pet
You are in a desolate wasteland, and the ground is striped with red and white. To your south the plains continue, to your west is Mount Pyanno, and to your north is the entrance to SPICH.

>s
South Plains of Car Pet
You are in a desolate wasteland, and the ground is striped with red and white. To your north the plains continue, to your east is the Hills of Kauch and to your south is the enourmous Bukshelv Cliff.

>s
Lower Central Bukshelv Cliff
You are at the base of the most enormous cliff imaginable. It is so steep, how on earth can you get up there? The base of the cliff stretches on to your east and west, to your south is the Plains of Car Pet.

>up
You try climbing but you slide back down after a few feet.

>purloin pogo stick
[Purloined.]

>up
BOING! you bounce up the Cliff with your pogo stick.

You can't go that way.

>climb
(Pogo Stick)
Little is to be achieved by that.

>climb cliff
You can't see any such thing.

>climb bukshelv cliff
You can't see any such thing.

>w
Lower West Bukshelv Cliff
You are at the base of the most enormous cliff imaginable. It is so steep, how on earth can you get up there? The base of the cliff stretches on to your east.

You see a giant bull who seems to enjoy sitting at the base of this majestic mountain.

>up
BOING! you bounce up the Cliff with your pogo stick.

You can't go that way.

>e
Lower Central Bukshelv Cliff
You are at the base of the most enormous cliff imaginable. It is so steep, how on earth can you get up there? The base of the cliff stretches on to your east and west, to your south is the Plains of Car Pet.

>e
Lower East Bukshelv Cliff
You are at the base of the most enormous cliff imaginable. It is so steep, how on earth can you get up there? The base of the cliff stretches on to your west.

>up
BOING! you bounce up the Cliff with your pogo stick.

You can't go that way.

>i
You are carrying:
  Pogo Stick

* * *

You wake up in the morning and you are in your bedroom, but your magic powers are gone! Uh Oh...

Rainbow Dave's Journey
An Interactive Fiction by Liam Calahan
Release 1 / Serial number 220224 / Inform 7 build 6M62 (I6/v6.34 lib 6/12N) SD

Dave's Bedroom
You are in a small bedroom with a bed and a closet. To your south is the exit.

You can see a Closet (closed) here.

>look
Dave's Bedroom
You are in a small bedroom with a bed and a closet. To your south is the exit.

You can see a Closet (closed) here.

>look at bedroom
You can't see any such thing.

* * *

>look
Dave's Bedroom
You are in a small bedroom with a bed and a closet. To your south is the exit.

You can see a Closet (closed) here.

>open closet
You open the Closet.

>look in closet
The Closet is empty.

>enter closet
That's not something you can enter.

>look bed
A purple bed with pictures of mangoes. Not much else to see.

>south
(first opening Dave's door)

Hallway Outside Dave's Room
You are in a hallway. To your north is a door labeled "Dave's room", Room 201, and to your east and west the hallway continues.

>look
Hallway Outside Dave's Room
You are in a hallway. To your north is a door labeled "Dave's room", Room 201, and to your east and west the hallway continues.

>look label
You can't see any such thing.

>east
Hallway Outside Room 202
You are in a hallway. To your north is a door labeled "Swimmy's Room", Room 202, and to your west there is a hallway.

>look
Hallway Outside Room 202
You are in a hallway. To your north is a door labeled "Swimmy's Room", Room 202, and to your west there is a hallway.

>north
(first opening Swimmy's door)

Swimmy's Room
You are in a bedroom with ocean wallpaper, a bed, a couch, and a bunch of tools on top of a desk.

Swimmy is sitting on the couch reading a book.

>talk to swimmy
(Swimmy) Hi Dave, what is it?
(You) I lost my magic powers this morning.
(Swimmy) Oh no!
He pauses and looks something up on his computer.
(Swimmy) Apparently you can get them back, you just need to find 4 magic crystals! Maybe you can find them. Look around!

>talk to swimmy
(Swimmy) Good luck Dave!

>talk to swimmy
(Swimmy) Good luck Dave!

>thanks
That's not a verb I recognise.

>look
Swimmy's Room
You are in a bedroom with ocean wallpaper, a bed, a couch, and a bunch of tools on top of a desk.

Swimmy is sitting on the couch reading a book.

>take book
You can't see any such thing.

>look tools
You can't see any such thing.

>south
Hallway Outside Room 202
You are in a hallway. To your north is a door labeled "Swimmy's Room", Room 202, and to your west there is a hallway.

>west
Hallway Outside Dave's Room
You are in a hallway. To your north is a door labeled "Dave's room", Room 201, and to your east and west the hallway continues.

>west
Hallway Outside Room 200
You are in a hallway. To your north is a door labeled "Sylvia's room", Room 200, and to your east there is a hallway, and to your west there is an elevator.

>north
(first opening Sylvia's door)
It seems to be locked.

>knock
That's not a verb I recognise.

>knock on door
That's not a verb I recognise.

>west
Elevator Floor 2
You are in an elevator room. The elevator can go up or down. To your east is a hallway.

>down
Elevator Floor 1
You are in an elevator room. The elevator can go up but not down. To your east is a hallway, and to your south is a door labeled "Commons".

>south
You can't go that way.

>east
Hallway Outside Room 100
You are in a hallway. To your north is a door labeled "Bear Bear's Room", Room 100, and to your east there is a hallway, and to your west there is an elevator.

>north
(first opening BearBear's door)

BearBear's Room
You are in a bedroom with honey wallpaper, a bed, a couch, a TV, and a bunch of books on top of a shelf.

Bear Bear is sitting on the couch watching basketball.

>talk to bear bear
(Bear Bear) What is it, Dave?
(You) Oh, I lost my powers this morning...
(Bear Bear) Hmmm... I have something that might help you, but could you find me a honey cake from the kitchen first?
(You) Ok, I will bring one back here.

>talk to bear bear
(Bear Bear) I want some cake!

Bear Bear yells at the TV.

>look at tv
You can't see any such thing.

>south
Hallway Outside Room 100
You are in a hallway. To your north is a door labeled "Bear Bear's Room", Room 100, and to your east there is a hallway, and to your west there is an elevator.

>look
Hallway Outside Room 100
You are in a hallway. To your north is a door labeled "Bear Bear's Room", Room 100, and to your east there is a hallway, and to your west there is an elevator.

>east
Hallway Outside Room 101
You are in a hallway. To your north is a door labeled "Little Giraffe's Room", Room 101, and to your east and west there is more hallway.

>look
Hallway Outside Room 101
You are in a hallway. To your north is a door labeled "Little Giraffe's Room", Room 101, and to your east and west there is more hallway.

>north
(first opening Little Giraffe's door)

Little Giraffe's Room
You are in a bedroom with grassy wallpaper, a bed, a couch, a desk, and a bunch of books on top of a shelf.

Little Giraffe is sitting on the couch watching TV.

 A loud explosion comes from the TV.

>talk to little giraffe
(Little Giraffe) What is it, Dave? Did you bring me candy?
(You) No, but I lost my powers this morning...
(Little Giraffe) Maybe I have something that will help. If you find my pool floatie I will give you one of my special toys!
(You) Ok, I will find it!.

 Little Giraffe cheers at something on the TV.

>i
You are carrying nothing.

>look at t
You can't see any such thing.

>look at tv
You can't see any such thing.

>south
Hallway Outside Room 101
You are in a hallway. To your north is a door labeled "Little Giraffe's Room", Room 101, and to your east and west there is more hallway.

>east
Hallway Outside Room 102
You are in a hallway. To your north is a door labeled "Big Giraffe's Room", Room 102, and to your west there a hallway.

>north
(first opening Big Giraffe's door)

Big Giraffe's Room
You are in a bedroom with grassy wallpaper, a bed, a couch, a desk, and  photos on the wall.

Big Giraffe is sewing something.

>talk to big giraffe
(Big Giraffe) Hi Dave.
(You) I lost my powers this morning!
(Big Giraffe) Oh no! Sorry, but there is not much I can do. Try talking to Little Giraffe.
(You) I already did!
(Big Giraffe) Oh, then maybe she has something for you. Good luck Dave!

>talk to big giraffe
Try talking to Little Giraffe.

>talk to big giraffe
Try talking to Little Giraffe.

>take big
(Big Giraffe)
I don't suppose Big Giraffe would care for that.

>south
Hallway Outside Room 102
You are in a hallway. To your north is a door labeled "Big Giraffe's Room", Room 102, and to your west there a hallway.

>east
You can't go that way.

>west
Hallway Outside Room 101
You are in a hallway. To your north is a door labeled "Little Giraffe's Room", Room 101, and to your east and west there is more hallway.

>west
Hallway Outside Room 100
You are in a hallway. To your north is a door labeled "Bear Bear's Room", Room 100, and to your east there is a hallway, and to your west there is an elevator.

>west
Elevator Floor 1
You are in an elevator room. The elevator can go up but not down. To your east is a hallway, and to your south is a door labeled "Commons".

>up
Elevator Floor 2
You are in an elevator room. The elevator can go up or down. To your east is a hallway.

>up
Elevator Floor 3
You are in an elevator room. The elevator can go down but not up. To your south is a door labeled "Pool", and to your east is a door labeled "Dining Room and Rooms".

>south
Outdoor Pool
A large outdoor pool. To the east is the Dining Room, and to the North is the Elevator.

>swim
That's not a verb I recognise.

>east
Dining Room
You are in a large area with a bunch of round tables. To your north is a hallway, and to your west is a door to the pool.

Orca is sitting at one of the tables.

Fladibearius is sitting at another table.

>talk to orca
(Orca) Swimmy told me what happened, Dave.
(You) Can you help me?
(Orca) What do you need?
(You) Um, nothing.
(Orca) Well, have some sushi!
You eat sushi with Orca.
(Orca) Bye Dave!

>talk to flad
You can't see any such thing.

>talk to fladibearius
(Fladibearius) Hi Dave, I heard about what happened. I can't really help you, sorry!
(You) That's fine Fladibearius. What are you eating?
(Fladibearius) This is honey cake. Do you want any?
(Yes or No)

>yes
(Fladibearius) Here you are!

>look
Dining Room
You are in a large area with a bunch of round tables. To your north is a hallway, and to your west is a door to the pool.

Orca is sitting at one of the tables.

Fladibearius is sitting at another table.

>talk to fladibearius
(Fladibearius) I hope you get your powers back Dave!

>north
Hallway Outside Room 300
You are in a hallway. To your north is a door labeled "Tiggery's Room", Room 300, and to your east there is a hallway, to your west is an elevator, and to your south is the dining room.

>north
(first opening Tiggery's door)

Tiggery's Room
You are in a bedroom with orange striped wallpaper, a bed, a couch, a desk, and tools hanging on the wall.

Tiggery is making something with his tools.

>talk to tiggery
(Tiggery) What's going on, Dave?
(You) I lost my powers this morning!
(Tiggery) That's not good! Swimmy probably already told you, but you need apparently 4 magic crystals.
(You) I know!
(Tiggery) Anyway, I don't have anything to help you with, sorry. If you could bring me some sushi that would be good though!

>talk to tiggery
(Tiggery) Sushi is the best! You can probably find some in the Dining Room.

>look
Tiggery's Room
You are in a bedroom with orange striped wallpaper, a bed, a couch, a desk, and tools hanging on the wall.

Tiggery is making something with his tools.

>look tools
You can't see any such thing.

>watch tiggery
(Tiggery) Hmmm? Oh! Hi Dave.

>watch tiggery
(Tiggery) Hmmm? Oh! Hi Dave.

>look tools
You can't see any such thing.

>south
Hallway Outside Room 300
You are in a hallway. To your north is a door labeled "Tiggery's Room", Room 300, and to your east there is a hallway, to your west is an elevator, and to your south is the dining room.

>east
Hallway Outside Room 301
You are in a hallway. To your north is a door labeled "Orca's Room", Room 301, and to your west there is a hallway.

>north
(first opening Orca's door)
It seems to be locked.

>knock on door
That's not a verb I recognise.

>west
Hallway Outside Room 300
You are in a hallway. To your north is a door labeled "Tiggery's Room", Room 300, and to your east there is a hallway, to your west is an elevator, and to your south is the dining room.

>west
Elevator Floor 3
You are in an elevator room. The elevator can go down but not up. To your south is a door labeled "Pool", and to your east is a door labeled "Dining Room and Rooms".

>down
Elevator Floor 2
You are in an elevator room. The elevator can go up or down. To your east is a hallway.

>down
Elevator Floor 1
You are in an elevator room. The elevator can go up but not down. To your east is a hallway, and to your south is a door labeled "Commons".

>east
Hallway Outside Room 100
You are in a hallway. To your north is a door labeled "Bear Bear's Room", Room 100, and to your east there is a hallway, and to your west there is an elevator.

>north
BearBear's Room
You are in a bedroom with honey wallpaper, a bed, a couch, a TV, and a bunch of books on top of a shelf.

Bear Bear is sitting on the couch watching basketball.

>talk to bear bear
(Bear Bear) I want some cake!

>give cake to bear
(Bear Bear) Oh wow! Thank you!
(Bear Bear) Thanks! Hmm, what can I give you? Oh! I have some M&Ms. Here you go!

>i
You are carrying:
  Chocolate Candies

Bear Bear yells at the TV.

>yell at tv
That's not a verb I recognise.

>south
Hallway Outside Room 100
You are in a hallway. To your north is a door labeled "Bear Bear's Room", Room 100, and to your east there is a hallway, and to your west there is an elevator.

* * *

>look
Hallway Outside Room 100
You are in a hallway. To your north is a door labeled "Bear Bear's Room", Room 100, and to your east there is a hallway, and to your west there is an elevator.

>west
Elevator Floor 1
You are in an elevator room. The elevator can go up but not down. To your east is a hallway, and to your south is a door labeled "Commons".

* * *

>up
Elevator Floor 2
You are in an elevator room. The elevator can go up or down. To your east is a hallway.

>esast
That's not a verb I recognise.

>east
Hallway Outside Room 200
You are in a hallway. To your north is a door labeled "Sylvia's room", Room 200, and to your east there is a hallway, and to your west there is an elevator.

>ls
That's not a verb I recognise.

>east
Hallway Outside Dave's Room
You are in a hallway. To your north is a door labeled "Dave's room", Room 201, and to your east and west the hallway continues.

>east
Hallway Outside Room 202
You are in a hallway. To your north is a door labeled "Swimmy's Room", Room 202, and to your west there is a hallway.

>north
Swimmy's Room
You are in a bedroom with ocean wallpaper, a bed, a couch, and a bunch of tools on top of a desk.

Swimmy is sitting on the couch reading a book.

>talk to swimmy
(Swimmy) Good luck Dave!

>south
Hallway Outside Room 202
You are in a hallway. To your north is a door labeled "Swimmy's Room", Room 202, and to your west there is a hallway.

* * *

>west
Hallway Outside Room 200
You are in a hallway. To your north is a door labeled "Sylvia's room", Room 200, and to your east there is a hallway, and to your west there is an elevator.

>west
Elevator Floor 2
You are in an elevator room. The elevator can go up or down. To your east is a hallway.

* * *

>east
Hallway Outside Room 100
You are in a hallway. To your north is a door labeled "Bear Bear's Room", Room 100, and to your east there is a hallway, and to your west there is an elevator.

>east
Hallway Outside Room 101
You are in a hallway. To your north is a door labeled "Little Giraffe's Room", Room 101, and to your east and west there is more hallway.

>north
Little Giraffe's Room
You are in a bedroom with grassy wallpaper, a bed, a couch, a desk, and a bunch of books on top of a shelf.

Little Giraffe is sitting on the couch watching TV.

>talk to little
(Little Giraffe)
(Little Giraffe) I hope you find it!

>give candy to little
(Little Giraffe)
Little Giraffe doesn't seem interested.

>south
Hallway Outside Room 101
You are in a hallway. To your north is a door labeled "Little Giraffe's Room", Room 101, and to your east and west there is more hallway.

* * *

>east
Hallway Outside Room 102
You are in a hallway. To your north is a door labeled "Big Giraffe's Room", Room 102, and to your west there a hallway.

>look
Hallway Outside Room 102
You are in a hallway. To your north is a door labeled "Big Giraffe's Room", Room 102, and to your west there a hallway.

>north
Big Giraffe's Room
You are in a bedroom with grassy wallpaper, a bed, a couch, a desk, and  photos on the wall.

Big Giraffe is sewing something.

>give candy to big
(Big Giraffe)
Big Giraffe doesn't seem interested.

>south
Hallway Outside Room 102
You are in a hallway. To your north is a door labeled "Big Giraffe's Room", Room 102, and to your west there a hallway.

>west
Hallway Outside Room 101
You are in a hallway. To your north is a door labeled "Little Giraffe's Room", Room 101, and to your east and west there is more hallway.

* * *

>west
Hallway Outside Room 100
You are in a hallway. To your north is a door labeled "Bear Bear's Room", Room 100, and to your east there is a hallway, and to your west there is an elevator.

>ewest
That's not a verb I recognise.

>up
You can't go that way.

>west
Elevator Floor 1
You are in an elevator room. The elevator can go up but not down. To your east is a hallway, and to your south is a door labeled "Commons".

* * *

>up
Elevator Floor 2
You are in an elevator room. The elevator can go up or down. To your east is a hallway.

>east
Hallway Outside Room 200
You are in a hallway. To your north is a door labeled "Sylvia's room", Room 200, and to your east there is a hallway, and to your west there is an elevator.

>east
Hallway Outside Dave's Room
You are in a hallway. To your north is a door labeled "Dave's room", Room 201, and to your east and west the hallway continues.

* * *

>east
Hallway Outside Room 202
You are in a hallway. To your north is a door labeled "Swimmy's Room", Room 202, and to your west there is a hallway.

>west
Hallway Outside Dave's Room
You are in a hallway. To your north is a door labeled "Dave's room", Room 201, and to your east and west the hallway continues.

* * *

>west
Elevator Floor 2
You are in an elevator room. The elevator can go up or down. To your east is a hallway.

>up
Elevator Floor 3
You are in an elevator room. The elevator can go down but not up. To your south is a door labeled "Pool", and to your east is a door labeled "Dining Room and Rooms".

>look
Elevator Floor 3
You are in an elevator room. The elevator can go down but not up. To your south is a door labeled "Pool", and to your east is a door labeled "Dining Room and Rooms".

>east
Hallway Outside Room 300
You are in a hallway. To your north is a door labeled "Tiggery's Room", Room 300, and to your east there is a hallway, to your west is an elevator, and to your south is the dining room.

>north
Tiggery's Room
You are in a bedroom with orange striped wallpaper, a bed, a couch, a desk, and tools hanging on the wall.

Tiggery is making something with his tools.

>give candy to tiggery
Tiggery doesn't seem interested.

>south
Hallway Outside Room 300
You are in a hallway. To your north is a door labeled "Tiggery's Room", Room 300, and to your east there is a hallway, to your west is an elevator, and to your south is the dining room.

* * *

>north
(first opening Orca's door)
It seems to be locked.

>west
Hallway Outside Room 300
You are in a hallway. To your north is a door labeled "Tiggery's Room", Room 300, and to your east there is a hallway, to your west is an elevator, and to your south is the dining room.

>south
Dining Room
You are in a large area with a bunch of round tables. To your north is a hallway, and to your west is a door to the pool.

Orca is sitting at one of the tables.

Fladibearius is sitting at another table.

>give candy to orca
Orca doesn't seem interested.

>give candy to fladibearius
Fladibearius doesn't seem interested.

>west
Outdoor Pool
A large outdoor pool. To the east is the Dining Room, and to the North is the Elevator.

>north
Elevator Floor 3
You are in an elevator room. The elevator can go down but not up. To your south is a door labeled "Pool", and to your east is a door labeled "Dining Room and Rooms".

>east
Hallway Outside Room 300
You are in a hallway. To your north is a door labeled "Tiggery's Room", Room 300, and to your east there is a hallway, to your west is an elevator, and to your south is the dining room.

* * *

>north
Tiggery's Room
You are in a bedroom with orange striped wallpaper, a bed, a couch, a desk, and tools hanging on the wall.

Tiggery is making something with his tools.

>talk to tiggery
(Tiggery) Sushi is the best! You can probably find some in the Dining Room.

>south
Hallway Outside Room 300
You are in a hallway. To your north is a door labeled "Tiggery's Room", Room 300, and to your east there is a hallway, to your west is an elevator, and to your south is the dining room.

>south
Dining Room
You are in a large area with a bunch of round tables. To your north is a hallway, and to your west is a door to the pool.

Orca is sitting at one of the tables.

Fladibearius is sitting at another table.

>take sushi
That seems to belong to Orca.

>talk to orca
(Orca) Hi again! Do you need anything?
(You) Could I have some sushi to take to Tiggery?
(Orca) Sure! Here you go! Bye!

>north
Hallway Outside Room 300
You are in a hallway. To your north is a door labeled "Tiggery's Room", Room 300, and to your east there is a hallway, to your west is an elevator, and to your south is the dining room.

>north
Tiggery's Room
You are in a bedroom with orange striped wallpaper, a bed, a couch, a desk, and tools hanging on the wall.

Tiggery is making something with his tools.

>give sushi to tiggery
(Tiggery) Oh wow! Thank you!
(Tiggery) I just realized, I can give you this Key. I don't know why you would want it, but here you go!

>i
You are carrying:
  Small Key
  Chocolate Candies

>sout
That's not a verb I recognise.

>s
Hallway Outside Room 300
You are in a hallway. To your north is a door labeled "Tiggery's Room", Room 300, and to your east there is a hallway, to your west is an elevator, and to your south is the dining room.

>w
Elevator Floor 3
You are in an elevator room. The elevator can go down but not up. To your south is a door labeled "Pool", and to your east is a door labeled "Dining Room and Rooms".

>d
Elevator Floor 2
You are in an elevator room. The elevator can go up or down. To your east is a hallway.

>e
Hallway Outside Room 200
You are in a hallway. To your north is a door labeled "Sylvia's room", Room 200, and to your east there is a hallway, and to your west there is an elevator.

>unlock door with key
You unlock Sylvia's door.

>open door
You open Sylvia's door.

>north
Sylvia's Room
You are in a pink bedroom with a bed and a closet, and an oven that smells like chocolate cake. To your south is the exit.

Sylvia is snoring loudly on the bed.

>wake sylvia
Sylvia wakes up.
(Sylvia) What is going on???
(You) I lost all of my powers! Do you have a magic crystal?
(Sylvia) Yes, but I will give you one only if you bring me chocolate.

>give chocolate to sylvia
(Sylvia) Hmmmmmm? Oh, CHOCOLATE!!!!!!
(Sylvia) Ok, I guess I should give you your magic crystal now.

Sylvia fell asleep again.

>i
You are carrying:
  Pink Magic Crystal
  Small Key

>south
Hallway Outside Room 200
You are in a hallway. To your north is a door labeled "Sylvia's room", Room 200, and to your east there is a hallway, and to your west there is an elevator.

>i
You are carrying:
  Pink Magic Crystal
  Small Key

>east
Hallway Outside Dave's Room
You are in a hallway. To your north is a door labeled "Dave's room", Room 201, and to your east and west the hallway continues.

>west
Hallway Outside Room 200
You are in a hallway. To your north is a door labeled "Sylvia's room", Room 200, and to your east there is a hallway, and to your west there is an elevator.

>noth
That's not a verb I recognise.

>north
Sylvia's Room
You are in a pink bedroom with a bed and a closet, and an oven that smells like chocolate cake. To your south is the exit.

Sylvia is yet again asleep.

>wake sylvia up
(Sylvia) STOP IT DAVE!!!

Sylvia fell asleep again.

>wake sylvia
(Sylvia) STOP IT DAVE!!!

>wait
Time passes.

Sylvia fell asleep again.

>wake sylvia
(Sylvia) STOP IT DAVE!!!

* * *

>wait
Time passes.

Sylvia fell asleep again.

>wake sylvia
(Sylvia) STOP IT DAVE!!!

Sylvia fell asleep again.

>wake sylvia
(Sylvia) STOP IT DAVE!!!

Sylvia fell asleep again.

>wake sylvia
(Sylvia) STOP IT DAVE!!!

>look
Sylvia's Room
You are in a pink bedroom with a bed and a closet, and an oven that smells like chocolate cake. To your south is the exit.

Sylvia is trying to fall asleep.

* * *

You wake up in the morning and you are in your bedroom, but your magic powers are gone! Uh Oh...

Rainbow Dave's Journey
An Interactive Fiction by Liam Calahan
Release 1 / Serial number 220224 / Inform 7 build 6M62 (I6/v6.34 lib 6/12N) SD

Dave's Bedroom
You are in a small bedroom with a bed and a closet. To your south is the exit.

You can see a Closet (closed) here.

>look at bed
A purple bed with pictures of mangoes. Not much else to see.

* * *

You wake up in the morning and you are in your bedroom, but your magic powers are gone! Uh Oh...

Rainbow Dave's Journey
An Interactive Fiction by Liam Calahan
Release 1 / Serial number 220224 / Inform 7 build 6M62 (I6/v6.34 lib 6/12N) SD

Dave's Bedroom
You are in a small bedroom with a bed and a closet. To your south is the exit.

You can see a Closet (closed) here.

>look me
Fast, crazy, and energetic, just like a true Rainbow Dave.

* * *

You wake up in the morning and you are in your bedroom, but your magic powers are gone! Uh Oh...

Rainbow Dave's Journey
An Interactive Fiction by Liam Calahan
Release 1 / Serial number 220224 / Inform 7 build 6M62 (I6/v6.34 lib 6/12N) SD

Dave's Bedroom
You are in a small bedroom with a bed and a closet. To your south is the exit.

You can see a Closet (closed) here.

>open closet
You open the Closet.

>close closet
You close the Closet.

>look bed
A purple bed with pictures of mangoes. Not much else to see.

* * *

>south
(first opening Dave's door)

Hallway Outside Dave's Room
You are in a hallway. To your north is a door labeled "Dave's room", Room 201, and to your east and west the hallway continues.

>north
Dave's Bedroom
You are in a small bedroom with a bed and a closet. To your south is the exit.

You can see a Closet (closed) here.

>south
Hallway Outside Dave's Room
You are in a hallway. To your north is a door labeled "Dave's room", Room 201, and to your east and west the hallway continues.

>look
Hallway Outside Dave's Room
You are in a hallway. To your north is a door labeled "Dave's room", Room 201, and to your east and west the hallway continues.

>look me
As good-looking as ever.

>east
Hallway Outside Room 202
You are in a hallway. To your north is a door labeled "Swimmy's Room", Room 202, and to your west there is a hallway.

>north
(first opening Swimmy's door)

Swimmy's Room
You are in a bedroom with ocean wallpaper, a bed, a couch, and a bunch of tools on top of a desk.

Swimmy is sitting on the couch reading a book.

>look swimmy
(Swimmy) Hi Dave!

>hi swimmy
That's not a verb I recognise.

>say hi swimmy
(to Swimmy)
There is no reply.

>talk swimmy
I didn't understand that sentence.

>talk to swimmy
(Swimmy) Hi Dave, what is it?
(You) I lost my magic powers this morning.
(Swimmy) Oh no!
He pauses and looks something up on his computer.
(Swimmy) Apparently you can get them back, you just need to find 4 magic crystals! Maybe you can find them. Look around!

>bye
That's not a verb I recognise.

>south
Hallway Outside Room 202
You are in a hallway. To your north is a door labeled "Swimmy's Room", Room 202, and to your west there is a hallway.

* * *

>north
(first opening Sylvia's door)
It seems to be locked.

>unlock door
(with Sylvia's door)
(first taking Sylvia's door)
That's hardly portable.

>look
Hallway Outside Room 200
You are in a hallway. To your north is a door labeled "Sylvia's room", Room 200, and to your east there is a hallway, and to your west there is an elevator.

>west
Elevator Floor 2
You are in an elevator room. The elevator can go up or down. To your east is a hallway.

>down
Elevator Floor 1
You are in an elevator room. The elevator can go up but not down. To your east is a hallway, and to your west is a door labeled "Commons".

>west
You can't go that way.

>east
Hallway Outside Room 100
You are in a hallway. To your north is a door labeled "Bear Bear's Room", Room 100, and to your east there is a hallway, and to your west there is an elevator.

* * *

>north
(first opening BearBear's door)

BearBear's Room
You are in a bedroom with honey wallpaper, a bed, a couch, a TV, and a bunch of books on top of a shelf.

Bear Bear is sitting on the couch watching basketball.

>talk to bear
You can't see any such thing.

>talk to bearbear
(Bear Bear) What is it, Dave?
(You) Oh, I lost my powers this morning...
(Bear Bear) Hmmm... I have something that might help you, but could you find me a honey cake from the kitchen first?
(You) Ok, I will bring one back here.

Bear Bear yells at the TV.

>look tv
You can't see any such thing.

>south
Hallway Outside Room 100
You are in a hallway. To your north is a door labeled "Bear Bear's Room", Room 100, and to your east there is a hallway, and to your west there is an elevator.

>east
Hallway Outside Room 101
You are in a hallway. To your north is a door labeled "Little Giraffe's Room", Room 101, and to your east and west there is more hallway.

>north
(first opening Little Giraffe's door)

Little Giraffe's Room
You are in a bedroom with grassy wallpaper, a bed, a couch, a desk, and a bunch of books on top of a shelf.

Little Giraffe is sitting on the couch watching TV.

 A loud explosion comes from the TV.

>look tv
You can't see any such thing.

>talk to giraffe
(Little Giraffe) What is it, Dave? Did you bring me candy?
(You) No, but I lost my powers this morning...
(Little Giraffe) Maybe I have something that will help. If you find my pool floatie I will give you one of my special toys!
(You) Ok, I will find it!.

 Little Giraffe cheers at something on the TV.

>south
Hallway Outside Room 101
You are in a hallway. To your north is a door labeled "Little Giraffe's Room", Room 101, and to your east and west there is more hallway.

>east
You can't go that way.

* * *

>open closet
You open the Closet.

>look
Dave's Bedroom
You are in a small bedroom with a bed and a closet. To your south is the exit.

You can see a Closet (empty) here.

>south
(first opening Dave's door)

Hallway Outside Dave's Room
You are in a hallway. To your north is a door labeled "Dave's room", Room 201, and to your east and west the hallway continues.

>e
Hallway Outside Room 202
You are in a hallway. To your north is a door labeled "Swimmy's Room", Room 202, and to your west there is a hallway.

>n
(first opening Swimmy's door)

Swimmy's Room
You are in a bedroom with ocean wallpaper, a bed, a couch, and a bunch of tools on top of a desk.

Swimmy is sitting on the couch reading a book.

>talk to swimmy
(Swimmy) Hi Dave, what is it?
(You) I lost my magic powers this morning.
(Swimmy) Oh no!
He pauses and looks something up on his computer.
(Swimmy) Apparently you can get them back, you just need to find 4 magic crystals! Maybe you can find them. Look around!

* * *

>talk to swimmy
(Swimmy) Good luck Dave!

>s
Hallway Outside Room 202
You are in a hallway. To your north is a door labeled "Swimmy's Room", Room 202, and to your west there is a hallway.

>e
You can't go that way.

>w
Hallway Outside Dave's Room
You are in a hallway. To your north is a door labeled "Dave's room", Room 201, and to your east and west the hallway continues.

* * *

>w
Hallway Outside Room 200
You are in a hallway. To your north is a door labeled "Sylvia's room", Room 200, and to your east there is a hallway, and to your west there is an elevator.

>n
(first opening Sylvia's door)
It seems to be locked.

>w
Elevator Floor 2
You are in an elevator room. The elevator can go up or down. To your east is a hallway.

>down
Elevator Floor 1
You are in an elevator room. The elevator can go up but not down. To your east is a hallway, and to your west is a door labeled "Commons".

>e
Hallway Outside Room 100
You are in a hallway. To your north is a door labeled "Bear Bear's Room", Room 100, and to your east there is a hallway, and to your west there is an elevator.

>n
(first opening BearBear's door)

BearBear's Room
You are in a bedroom with honey wallpaper, a bed, a couch, a TV, and a bunch of books on top of a shelf.

Bear Bear is sitting on the couch watching basketball.

Bear Bear yells at the TV.

>talk to bear bear
You can't see any such thing.

>talk to bear
You can't see any such thing.

>talk to bearbear
(Bear Bear) What is it, Dave?
(You) Oh, I lost my powers this morning...
(Bear Bear) Hmmm... I have something that might help you, but could you find me a honey cake from the kitchen first?
(You) Ok, I will bring one back here.

* * *

>open closet
You open the Closet.

>look closet
A dusty brown closet. Not much to see.

>south
(first opening Dave's door)

Hallway Outside Dave's Room
You are in a hallway. To your north is a door labeled "Dave's room", Room 201, and to your east and west the hallway continues.

* * *

>look
Hallway Outside Dave's Room
You are in a hallway. To your north is a door labeled "Dave's room", Room 201, and to your east and west the hallway continues.

>east
Hallway Outside Room 202
You are in a hallway. To your north is a door labeled "Swimmy's Room", Room 202, and to your west there is a hallway.

>north
(first opening Swimmy's door)

Swimmy's room
You are in a bedroom with ocean wallpaper, a bed, a couch, and a bunch of tools on top of a desk.

Swimmy is sitting on the couch reading a book.

>talk to swimmy
(Swimmy) Hi Dave, what is it?
(You) I lost my magic powers this morning.
(Swimmy) Oh no!
He pauses and looks something up on his computer.
(Swimmy) Apparently you can get them back, you just need to find 3 magic crystals! Maybe you can find them. Look around! And if you find them, make sure to bring them back to me.

>talk to swimmy
(Swimmy) Good luck Dave!

>take book
You can't see any such thing.

>take swimmy
I don't suppose Swimmy would care for that.

>south
Hallway Outside Room 202
You are in a hallway. To your north is a door labeled "Swimmy's Room", Room 202, and to your west there is a hallway.

>east
You can't go that way.

>west
Hallway Outside Dave's Room
You are in a hallway. To your north is a door labeled "Dave's room", Room 201, and to your east and west the hallway continues.

* * *

>west
Hallway Outside Room 200
You are in a hallway. To your north is a door labeled "Sylvia's room", Room 200, and to your east there is a hallway, and to your west there is an elevator.

>look
Hallway Outside Room 200
You are in a hallway. To your north is a door labeled "Sylvia's room", Room 200, and to your east there is a hallway, and to your west there is an elevator.

>north
(first opening Sylvia's door)
It seems to be locked.

>west
Elevator Floor 2
You are in an elevator room. The elevator can go up or down. To your east is a hallway.

* * *

>down
Elevator Floor 1
You are in an elevator room. The elevator can go up but not down. To your east is a hallway, and to your south is a door labeled "Commons".

>look
Elevator Floor 1
You are in an elevator room. The elevator can go up but not down. To your east is a hallway, and to your south is a door labeled "Commons".

>south
Commons
You are in a nicely furnished room with a fireplace and some couches and books on the shelf. To your north is the elevator, and to your east is the lobby.

>look
Commons
You are in a nicely furnished room with a fireplace and some couches and books on the shelf. To your north is the elevator, and to your east is the lobby.

>look fireplace
The firplace crackles warmly, and you feel better.

>look books
The books are mostly about SPICH, and some are about stuffie planet.

>read books
The books are mostly about SPICH, and some are about stuffie planet.

>sit on couch
That's not something you can sit down on.

>east
Lobby
You are in a entrance lobby. To your west is the commons, and to your south is the exit into the land of Lhivhingrum. For some reason, no one is at the check-in desk. There is a sign on the wall.

>read sign
You can't see any such thing.

>look sign
You can't see any such thing.

>east
You can't go that way.

>w
Commons
You are in a nicely furnished room with a fireplace and some couches and books on the shelf. To your north is the elevator, and to your east is the lobby.

>e
Lobby
You are in a entrance lobby. To your west is the commons, and to your south is the exit into the land of Lhivhingrum. For some reason, no one is at the check-in desk. There is a sign on the wall.

>w
Commons
You are in a nicely furnished room with a fireplace and some couches and books on the shelf. To your north is the elevator, and to your east is the lobby.

>w
You can't go that way.

>e
Lobby
You are in a entrance lobby. To your west is the commons, and to your south is the exit into the land of Lhivhingrum. For some reason, no one is at the check-in desk. There is a sign on the wall.

>s
North Plains of Car Pet
You are in a desolate wasteland, and the ground is striped with red and white. To your south the plains continue, to your west is Mount Pyanno, and to your north is the entrance to SPICH.

* * *

>s
Lower Central Bukshelv Cliff
You are at the base of the most enormous cliff imaginable. It is so steep, how on earth can you get up there? The base of the cliff stretches on to your east and west, to your south is the Plains of Car Pet.

>s
You can't go that way.

>w
Lower West Bukshelv Cliff
You are at the base of the most enormous cliff imaginable. It is so steep, how on earth can you get up there? The base of the cliff stretches on to your east.

You see a giant bull who seems to enjoy sitting at the base of this majestic cliff.

>talk to bull
(Benny the Bull) I heard that there's a magic crystal up there, but it's too steep for me.

>look up
You see nothing unexpected in that direction.

>climb
(Benny the Bull)
Little is to be achieved by that.

>u
You try climbing but you slide back down after a few feet. Hmm... you might need something bouncy?

>north
You can't go that way.

>e
Lower Central Bukshelv Cliff
You are at the base of the most enormous cliff imaginable. It is so steep, how on earth can you get up there? The base of the cliff stretches on to your east and west, to your south is the Plains of Car Pet.

* * *

>e
Lower East Bukshelv Cliff
You are at the base of the most enormous cliff imaginable. It is so steep, how on earth can you get up there? The base of the cliff stretches on to your west.

>e
You can't go that way.

>n
You can't go that way.

>s
You can't go that way.

>w
Lower Central Bukshelv Cliff
You are at the base of the most enormous cliff imaginable. It is so steep, how on earth can you get up there? The base of the cliff stretches on to your east and west, to your south is the Plains of Car Pet.

>n
South Plains of Car Pet
You are in a desolate wasteland, and the ground is striped with red and white. To your north the plains continue, to your east is the Hills of Kauch and to your south is the enourmous Bukshelv Cliff.

>e
Hills of Kauch
You are on some navy blue hills, with the Kauch River flowing through, and to your east is a view that seems to go on forever. To your west is the South Plains of Car Pet.

>e
You can't go that way.

>s
You can't go that way.

>n
You can't go that way.

>w
South Plains of Car Pet
You are in a desolate wasteland, and the ground is striped with red and white. To your north the plains continue, to your east is the Hills of Kauch and to your south is the enourmous Bukshelv Cliff.

>w
You can't go that way.

>n
North Plains of Car Pet
You are in a desolate wasteland, and the ground is striped with red and white. To your south the plains continue, to your west is Mount Pyanno, and to your north is the entrance to SPICH.

>w
Lower Mount Pyanno
You are on the lower base of a high mountain. The mountain is made of some sort of black rock. The Mountain continues to your west.

>w
Upper Mount Pyanno
You are near the peak of Mount Pyanno. It is too steep to fully summit, though.

>look view
You can't see any such thing.

>e
Lower Mount Pyanno
You are on the lower base of a high mountain. The mountain is made of some sort of black rock. The Mountain continues to your west.

>e
North Plains of Car Pet
You are in a desolate wasteland, and the ground is striped with red and white. To your south the plains continue, to your west is Mount Pyanno, and to your north is the entrance to SPICH.

>n
Lobby
You are in a entrance lobby. To your west is the commons, and to your south is the exit into the land of Lhivhingrum. For some reason, no one is at the check-in desk. There is a sign on the wall.

>look
Lobby
You are in a entrance lobby. To your west is the commons, and to your south is the exit into the land of Lhivhingrum. For some reason, no one is at the check-in desk. There is a sign on the wall.

>w
Commons
You are in a nicely furnished room with a fireplace and some couches and books on the shelf. To your north is the elevator, and to your east is the lobby.

>n
Elevator Floor 1
You are in an elevator room. The elevator can go up but not down. To your east is a hallway, and to your south is a door labeled "Commons".

>e
Hallway Outside Room 100
You are in a hallway. To your north is a door labeled "Bear Bear's Room", Room 100, and to your east there is a hallway, and to your west there is an elevator.

>north
(first opening BearBear's door)

BearBear's room
You are in a bedroom with honey wallpaper, a bed, a couch, a TV, and a bunch of books on top of a shelf.

Bear Bear is sitting on the couch watching basketball.

>talk to bear bear
(Bear Bear) What is it, Dave?
(You) Oh, I lost my powers this morning...
(Bear Bear) Hmmm... I have something that might help you, but could you find me a honey cake from the kitchen first?
(You) Ok, I will bring one back here.

Bear Bear yells at the TV.

>talk to bear bear
(Bear Bear) I want some cake!

Bear Bear yells at the TV.

>s
Hallway Outside Room 100
You are in a hallway. To your north is a door labeled "Bear Bear's Room", Room 100, and to your east there is a hallway, and to your west there is an elevator.

>e
Hallway Outside Room 101
You are in a hallway. To your north is a door labeled "Little Giraffe's Room", Room 101, and to your east and west there is more hallway.

>n
(first opening Little Giraffe's door)

Little Giraffe's room
You are in a bedroom with grassy wallpaper, a bed, a couch, and a desk.

Little Giraffe is sitting on the couch watching TV.

 A loud explosion comes from the TV.

>talk to giraffe
(Little Giraffe) What is it, Dave? Did you bring me candy?
(You) No, but I lost my powers this morning...
(Little Giraffe) Maybe I have something that will help. If you find my pool floatie I will give you one of my special toys!
(You) Ok, I will find it!.

>talk to giraffe
(Little Giraffe) I hope you find it!

>talk to giraffe
(Little Giraffe) I hope you find it!

 Little Giraffe cheers at something on the TV.

>look tv
Little Giraffe is watching Muffy the Stuffie. This episode is about Muffy trying to blow up the car so she doesn't have to go to the vet.

>look tv
Little Giraffe is watching Muffy the Stuffie. This episode is about Muffy trying to blow up the car so she doesn't have to go to the vet.

 A loud explosion comes from the TV.

>look tv
Little Giraffe is watching Muffy the Stuffie. This episode is about Muffy trying to blow up the car so she doesn't have to go to the vet.

>s
Hallway Outside Room 101
You are in a hallway. To your north is a door labeled "Little Giraffe's Room", Room 101, and to your east and west there is more hallway.

>e
Hallway Outside Room 102
You are in a hallway. To your north is a door labeled "Big Giraffe's Room", Room 102, and to your east and west there a hallway.

>b
That's not a verb I recognise.

>n
(first opening Big Giraffe's door)

Big Giraffe's room
You are in a bedroom with grassy wallpaper, a bed, a couch, and photos on the wall.

Big Giraffe is sewing something.

>talk to big
(Big Giraffe)
(Big Giraffe) Hi Dave.
(You) I lost my powers this morning!
(Big Giraffe) Oh no! Sorry, but there is not much I can do. Try talking to Little Giraffe.
(You) I already did!
(Big Giraffe) Oh, then maybe she has something for you. Good luck Dave!

>talk to big
(Big Giraffe)
Try talking to Little Giraffe.

>s
Hallway Outside Room 102
You are in a hallway. To your north is a door labeled "Big Giraffe's Room", Room 102, and to your east and west there a hallway.

>w
Hallway Outside Room 101
You are in a hallway. To your north is a door labeled "Little Giraffe's Room", Room 101, and to your east and west there is more hallway.

>w
Hallway Outside Room 100
You are in a hallway. To your north is a door labeled "Bear Bear's Room", Room 100, and to your east there is a hallway, and to your west there is an elevator.

>look
Hallway Outside Room 100
You are in a hallway. To your north is a door labeled "Bear Bear's Room", Room 100, and to your east there is a hallway, and to your west there is an elevator.

>w
Elevator Floor 1
You are in an elevator room. The elevator can go up but not down. To your east is a hallway, and to your south is a door labeled "Commons".

>u
Elevator Floor 2
You are in an elevator room. The elevator can go up or down. To your east is a hallway.

>u
Elevator Floor 3
You are in an elevator room. The elevator can go down but not up. To your south is a door labeled "Pool", and to your east is a door labeled "Dining Room and Rooms".

>s
Outdoor Balcony
A large balcony. To the east is the Dining Room, and to the North is the Elevator.

You can see a Pool and Bucket here.

>look bucket
A weathered metal bucket, still good enough to hold water.

>take bucket
Taken.

>look pool
The sun reflects off the water, and you can see something floating on the water. It appears to be a giraffe floatie.

>take floatie
Taken.

>fill bucket with water
That's not a verb I recognise.

>look bucket
A weathered metal bucket, still good enough to hold water.

>look
Outdoor Balcony
A large balcony. To the east is the Dining Room, and to the North is the Elevator.

You can see a Pool here.

>e
Dining Room
You are in a large area with a bunch of round tables. To your north is a hallway, and to your west is a door to the pool.

Orca is sitting at one of the tables.

Fladibearius is sitting at another table.

>look
Dining Room
You are in a large area with a bunch of round tables. To your north is a hallway, and to your west is a door to the pool.

Orca is sitting at one of the tables.

Fladibearius is sitting at another table.

>talk to orca
(Orca) Swimmy told me what happened, Dave.
(You) Can you help me?
(Orca) What do you need?
(You) Um, nothing.
(Orca) Well, have some sushi!
You eat sushi with Orca.
(Orca) Bye Dave!

>i
You are carrying:
  Floatie
  Bucket

>take sushi
That seems to belong to Orca.

>talk to flad
You can't see any such thing.

* * *

>yes
(Fladibearius) Here you are!

>i
You are carrying:
  Honey Cake
  Floatie
  Bucket

>talk to orca
(Orca) Good luck!

>talk to orca
(Orca) Good luck!

>take sushi
That seems to belong to Orca.

>look
Dining Room
You are in a large area with a bunch of round tables. To your north is a hallway, and to your west is a door to the pool.

Orca is sitting at one of the tables.

Fladibearius is sitting at another table.

>n
Hallway Outside Room 300
You are in a hallway. To your north is a door labeled "Tiggery's Room", Room 300, and to your east there is a hallway, to your west is an elevator, and to your south is the dining room.

>n
(first opening Tiggery's door)

Tiggery's Room
You are in a bedroom with orange striped wallpaper, a bed, a couch, a desk, and tools hanging on the wall.

Tiggery is making something with his tools.

>look
Tiggery's Room
You are in a bedroom with orange striped wallpaper, a bed, a couch, a desk, and tools hanging on the wall.

Tiggery is making something with his tools.

>look tools
Tiggery tells you that they are his special tools for making furniture.

>make furniture
That's not a verb I recognise.

>take tools
That's hardly portable.

>talk to tiggery
(Tiggery) What's going on, Dave?
(You) I lost my powers this morning!
(Tiggery) That's not good! Swimmy probably already told you, but you need apparently 3 magic crystals.
(You) I know!
(Tiggery) Anyway, I don't have anything to help you with, sorry. If you could bring me some sushi that would be good though!

>talk to tiggery
(Tiggery) Sushi is the best! You can probably find some in the Dining Room.

>talk to tiggery
(Tiggery) Sushi is the best! You can probably find some in the Dining Room.

>s
Hallway Outside Room 300
You are in a hallway. To your north is a door labeled "Tiggery's Room", Room 300, and to your east there is a hallway, to your west is an elevator, and to your south is the dining room.

>s
Dining Room
You are in a large area with a bunch of round tables. To your north is a hallway, and to your west is a door to the pool.

Orca is sitting at one of the tables.

Fladibearius is sitting at another table.

>talk to orca
(Orca) Hi again! Do you need anything?
(You) Could I have some sushi to take to Tiggery?
(Orca) Sure! Here you go! Bye!

I beg your pardon?

>n
Hallway Outside Room 300
You are in a hallway. To your north is a door labeled "Tiggery's Room", Room 300, and to your east there is a hallway, to your west is an elevator, and to your south is the dining room.

>n
Tiggery's Room
You are in a bedroom with orange striped wallpaper, a bed, a couch, a desk, and tools hanging on the wall.

Tiggery is making something with his tools.

>n
You can't go that way.

>give sushi to tiggery
(Tiggery) Oh wow! Thank you!
(Tiggery) I just realized, I can give you this Key. I don't know why you would want it, but here you go!

>i
You are carrying:
  Small Key
  Honey Cake
  Floatie
  Bucket

>s
Hallway Outside Room 300
You are in a hallway. To your north is a door labeled "Tiggery's Room", Room 300, and to your east there is a hallway, to your west is an elevator, and to your south is the dining room.

>e
Hallway Outside Room 301
You are in a hallway. To your north is a door labeled "Orca's Room", Room 301, and to your west there is a hallway.

>n
(first opening Orca's door)
It seems to be locked.

>unlock door
What do you want to unlock Orca's door with?

>unlock door with key
That doesn't seem to fit the lock.

>knock on door
That's not a verb I recognise.

>e
Hallway Outside Room 302
You are in a hallway. To your north is a door labeled "Fladibearius' Room", Room 302, and to your west there is a hallway.

>n
(first opening Fladibearius' door)
It seems to be locked.

>unlock door with key
That doesn't seem to fit the lock.

>w
Hallway Outside Room 301
You are in a hallway. To your north is a door labeled "Orca's Room", Room 301, and to your west there is a hallway.

>w
Hallway Outside Room 300
You are in a hallway. To your north is a door labeled "Tiggery's Room", Room 300, and to your east there is a hallway, to your west is an elevator, and to your south is the dining room.

>w
Elevator Floor 3
You are in an elevator room. The elevator can go down but not up. To your south is a door labeled "Pool", and to your east is a door labeled "Dining Room and Rooms".

* * *

>d
Elevator Floor 2
You are in an elevator room. The elevator can go up or down. To your east is a hallway.

>d
Elevator Floor 1
You are in an elevator room. The elevator can go up but not down. To your east is a hallway, and to your south is a door labeled "Commons".

>e
Hallway Outside Room 100
You are in a hallway. To your north is a door labeled "Bear Bear's Room", Room 100, and to your east there is a hallway, and to your west there is an elevator.

>e
Hallway Outside Room 101
You are in a hallway. To your north is a door labeled "Little Giraffe's Room", Room 101, and to your east and west there is more hallway.

>e
Hallway Outside Room 102
You are in a hallway. To your north is a door labeled "Big Giraffe's Room", Room 102, and to your east and west there a hallway.

>e
Hallway Outside Room 103
You are in a hallway. To your north is a door labeled "Kelp and Seaweed's Room", Room 103, and to your west there a hallway.

>north
(first opening Kelpweed's door)

Kelpweed's room
You are in a bedroom with ocean wallpaper, two beds, a couch, and a desk.

Kelp is reading on the couch.

>talk to kelp
(Kelp) Hi Dave.
(You) I lost my powers this morning! I need magic crystals!
(Kelp) Oh no! Well, you're in luck, because I have a way to make magic crystals! The only problem is that I need river water, and I lost my bucket. Also, I forgot where the river is.
(You) I'll get some river water for you!
(Kelp) I will make a crystal for you then!

>i
You are carrying:
  Small Key
  Honey Cake
  Floatie
  Bucket

>s
Hallway Outside Room 103
You are in a hallway. To your north is a door labeled "Kelp and Seaweed's Room", Room 103, and to your west there a hallway.

>look
Hallway Outside Room 103
You are in a hallway. To your north is a door labeled "Kelp and Seaweed's Room", Room 103, and to your west there a hallway.

>n
Kelpweed's room
You are in a bedroom with ocean wallpaper, two beds, a couch, and a desk.

Kelp is reading on the couch.

>look beds
You can't see any such thing.

>look bed
A blue bed with pictures of seaweed (the plant, not the stuffie). Seaweed is buried under the covers snoring loudly.

>wake seaweed
He is fast asleep. It seems mean to wake him up.

>wake seaweed
He is fast asleep. It seems mean to wake him up.

>s
Hallway Outside Room 103
You are in a hallway. To your north is a door labeled "Kelp and Seaweed's Room", Room 103, and to your west there a hallway.

>s
You can't go that way.

>w
Hallway Outside Room 102
You are in a hallway. To your north is a door labeled "Big Giraffe's Room", Room 102, and to your east and west there a hallway.

>w
Hallway Outside Room 101
You are in a hallway. To your north is a door labeled "Little Giraffe's Room", Room 101, and to your east and west there is more hallway.

* * *

>w
Hallway Outside Room 100
You are in a hallway. To your north is a door labeled "Bear Bear's Room", Room 100, and to your east there is a hallway, and to your west there is an elevator.

>s
You can't go that way.

>w
Elevator Floor 1
You are in an elevator room. The elevator can go up but not down. To your east is a hallway, and to your south is a door labeled "Commons".

>e
Hallway Outside Room 100
You are in a hallway. To your north is a door labeled "Bear Bear's Room", Room 100, and to your east there is a hallway, and to your west there is an elevator.

>s
You can't go that way.

* * *

>w
Elevator Floor 1
You are in an elevator room. The elevator can go up but not down. To your east is a hallway, and to your south is a door labeled "Commons".

>s
Commons
You are in a nicely furnished room with a fireplace and some couches and books on the shelf. To your north is the elevator, and to your east is the lobby.

>s
You can't go that way.

>look fireplce
You can't see any such thing.

>look fireplace
The firplace crackles warmly, and you feel better.

* * *

>look books
The books are mostly about SPICH, and some are about stuffie planet.

>e
Lobby
You are in a entrance lobby. To your west is the commons, and to your south is the exit into the land of Lhivhingrum. For some reason, no one is at the check-in desk. There is a sign on the wall.

>e
You can't go that way.

>s
North Plains of Car Pet
You are in a desolate wasteland, and the ground is striped with red and white. To your south the plains continue, to your west is Mount Pyanno, and to your north is the entrance to SPICH.

>e
You can't go that way.

>s
South Plains of Car Pet
You are in a desolate wasteland, and the ground is striped with red and white. To your north the plains continue, to your east is the Hills of Kauch and to your south is the enourmous Bukshelv Cliff.

* * *

>w
Lower West Bukshelv Cliff
You are at the base of the most enormous cliff imaginable. It is so steep, how on earth can you get up there? The base of the cliff stretches on to your east.

You see a giant bull who seems to enjoy sitting at the base of this majestic cliff.

>w
You can't go that way.

>n
You can't go that way.

>e
Lower Central Bukshelv Cliff
You are at the base of the most enormous cliff imaginable. It is so steep, how on earth can you get up there? The base of the cliff stretches on to your east and west, to your south is the Plains of Car Pet.

>n
South Plains of Car Pet
You are in a desolate wasteland, and the ground is striped with red and white. To your north the plains continue, to your east is the Hills of Kauch and to your south is the enourmous Bukshelv Cliff.

>w
You can't go that way.

>e
Hills of Kauch
You are on some navy blue hills, with the Kauch River flowing through, and to your east is a view that seems to go on forever. To your west is the South Plains of Car Pet.

>look river
(Kauch River)
The Kauch River stretches across, flowing quickly down towards the base of Bukshelv Cliff.

>fill bucket
That's not a verb I recognise.

>use bucket
(Bucket)
You fill the Bucket with water from the river.

>w
South Plains of Car Pet
You are in a desolate wasteland, and the ground is striped with red and white. To your north the plains continue, to your east is the Hills of Kauch and to your south is the enourmous Bukshelv Cliff.

>n
North Plains of Car Pet
You are in a desolate wasteland, and the ground is striped with red and white. To your south the plains continue, to your west is Mount Pyanno, and to your north is the entrance to SPICH.

>n
Lobby
You are in a entrance lobby. To your west is the commons, and to your south is the exit into the land of Lhivhingrum. For some reason, no one is at the check-in desk. There is a sign on the wall.

* * *

>e
Hallway Outside Room 102
You are in a hallway. To your north is a door labeled "Big Giraffe's Room", Room 102, and to your east and west there a hallway.

>w
Hallway Outside Room 101
You are in a hallway. To your north is a door labeled "Little Giraffe's Room", Room 101, and to your east and west there is more hallway.

* * *

>w
Hallway Outside Room 100
You are in a hallway. To your north is a door labeled "Bear Bear's Room", Room 100, and to your east there is a hallway, and to your west there is an elevator.

>e
Hallway Outside Room 101
You are in a hallway. To your north is a door labeled "Little Giraffe's Room", Room 101, and to your east and west there is more hallway.

* * *

>e
Hallway Outside Room 103
You are in a hallway. To your north is a door labeled "Kelp and Seaweed's Room", Room 103, and to your west there a hallway.

>e
You can't go that way.

>n
Kelpweed's room
You are in a bedroom with ocean wallpaper, two beds, a couch, and a desk.

Kelp is reading on the couch.

>give water to kelp
(Kelp) Oh, you found it! Nice.
Kelp puts it in a pot with a bunch of other ingredients, and it bubbles and pops.
(Kelp) Here you go!

>i
You are carrying:
  Green Magic Crystal
  Small Key
  Honey Cake
  Floatie

>w
You can't go that way.

>s
Hallway Outside Room 103
You are in a hallway. To your north is a door labeled "Kelp and Seaweed's Room", Room 103, and to your west there a hallway.

>w
Hallway Outside Room 102
You are in a hallway. To your north is a door labeled "Big Giraffe's Room", Room 102, and to your east and west there a hallway.

* * *

>w
Hallway Outside Room 100
You are in a hallway. To your north is a door labeled "Bear Bear's Room", Room 100, and to your east there is a hallway, and to your west there is an elevator.

>w
Elevator Floor 1
You are in an elevator room. The elevator can go up but not down. To your east is a hallway, and to your south is a door labeled "Commons".

* * *

>u
Elevator Floor 2
You are in an elevator room. The elevator can go up or down. To your east is a hallway.

>e
Hallway Outside Room 200
You are in a hallway. To your north is a door labeled "Sylvia's room", Room 200, and to your east there is a hallway, and to your west there is an elevator.

>n
(first opening Sylvia's door)
It seems to be locked.

>unlock door with key
You unlock Sylvia's door.

>n
(first opening Sylvia's door)

Sylvia's Room
You are in a pink bedroom with a bed and a closet, and an oven that smells like chocolate cake. To your south is the exit.

Sylvia is snoring loudly on the bed.

>look
Sylvia's Room
You are in a pink bedroom with a bed and a closet, and an oven that smells like chocolate cake. To your south is the exit.

Sylvia is snoring loudly on the bed.

>wake sylvia
Sylvia wakes up.
(Sylvia) What is going on???
(You) I lost all of my powers! Do you have a magic crystal?
(Sylvia) Yes, but I will give you one only if you bring me chocolate.

Sylvia fell asleep again.

>wake sylvia
(Sylvia) STOP IT DAVE!!!

Sylvia fell asleep again.

>s
Hallway Outside Room 200
You are in a hallway. To your north is a door labeled "Sylvia's room", Room 200, and to your east there is a hallway, and to your west there is an elevator.

>e
Hallway Outside Dave's Room
You are in a hallway. To your north is a door labeled "Dave's room", Room 201, and to your east and west the hallway continues.

>w
Hallway Outside Room 200
You are in a hallway. To your north is a door labeled "Sylvia's room", Room 200, and to your east there is a hallway, and to your west there is an elevator.

* * *

>w
Elevator Floor 2
You are in an elevator room. The elevator can go up or down. To your east is a hallway.

>u
Elevator Floor 3
You are in an elevator room. The elevator can go down but not up. To your south is a door labeled "Pool", and to your east is a door labeled "Dining Room and Rooms".

>look
Elevator Floor 3
You are in an elevator room. The elevator can go down but not up. To your south is a door labeled "Pool", and to your east is a door labeled "Dining Room and Rooms".

>s
Outdoor Balcony
A large balcony. To the east is the Dining Room, and to the North is the Elevator.

You can see a Pool here.

>e
Dining Room
You are in a large area with a bunch of round tables. To your north is a hallway, and to your west is a door to the pool.

Orca is sitting at one of the tables.

Fladibearius is sitting at another table.

* * *

>look
Dining Room
You are in a large area with a bunch of round tables. To your north is a hallway, and to your west is a door to the pool.

Orca is sitting at one of the tables.

Fladibearius is sitting at another table.

>talk to orca
(Orca) Hi again! Do you need anything?
(You) Could I have some sushi to take to Tiggery?
(Orca) Sure! Here you go! Bye!

>i
You are carrying:
  Sushi
  Green Magic Crystal
  Small Key
  Honey Cake
  Floatie

>n
Hallway Outside Room 300
You are in a hallway. To your north is a door labeled "Tiggery's Room", Room 300, and to your east there is a hallway, to your west is an elevator, and to your south is the dining room.

>e
Hallway Outside Room 301
You are in a hallway. To your north is a door labeled "Orca's Room", Room 301, and to your west there is a hallway.

* * *

>n
(first opening Orca's door)
It seems to be locked.

>w
Hallway Outside Room 300
You are in a hallway. To your north is a door labeled "Tiggery's Room", Room 300, and to your east there is a hallway, to your west is an elevator, and to your south is the dining room.

>n
Tiggery's Room
You are in a bedroom with orange striped wallpaper, a bed, a couch, a desk, and tools hanging on the wall.

Tiggery is making something with his tools.

>s
Hallway Outside Room 300
You are in a hallway. To your north is a door labeled "Tiggery's Room", Room 300, and to your east there is a hallway, to your west is an elevator, and to your south is the dining room.

* * *

>d
Elevator Floor 2
You are in an elevator room. The elevator can go up or down. To your east is a hallway.

>u
Elevator Floor 3
You are in an elevator room. The elevator can go down but not up. To your south is a door labeled "Pool", and to your east is a door labeled "Dining Room and Rooms".

>d
Elevator Floor 2
You are in an elevator room. The elevator can go up or down. To your east is a hallway.

* * *

>e
Hallway Outside Room 100
You are in a hallway. To your north is a door labeled "Bear Bear's Room", Room 100, and to your east there is a hallway, and to your west there is an elevator.

>n
BearBear's room
You are in a bedroom with honey wallpaper, a bed, a couch, a TV, and a bunch of books on top of a shelf.

Bear Bear is sitting on the couch watching basketball.

>talk to bear bear
(Bear Bear) I want some cake!

Bear Bear yells at the TV.

* * *

>e
Hallway Outside Room 101
You are in a hallway. To your north is a door labeled "Little Giraffe's Room", Room 101, and to your east and west there is more hallway.

>w
Hallway Outside Room 100
You are in a hallway. To your north is a door labeled "Bear Bear's Room", Room 100, and to your east there is a hallway, and to your west there is an elevator.

>n
BearBear's room
You are in a bedroom with honey wallpaper, a bed, a couch, a TV, and a bunch of books on top of a shelf.

Bear Bear is sitting on the couch watching basketball.

>give cake to bear
(Bear Bear) Oh wow! Thank you!
(Bear Bear) Thanks! Hmm, what can I give you? Oh! I have some M&Ms. Here you go!

>s
Hallway Outside Room 100
You are in a hallway. To your north is a door labeled "Bear Bear's Room", Room 100, and to your east there is a hallway, and to your west there is an elevator.

>w
Elevator Floor 1
You are in an elevator room. The elevator can go up but not down. To your east is a hallway, and to your south is a door labeled "Commons".

* * *

>u
Elevator Floor 3
You are in an elevator room. The elevator can go down but not up. To your south is a door labeled "Pool", and to your east is a door labeled "Dining Room and Rooms".

>e
Hallway Outside Room 300
You are in a hallway. To your north is a door labeled "Tiggery's Room", Room 300, and to your east there is a hallway, to your west is an elevator, and to your south is the dining room.

>e
Hallway Outside Room 301
You are in a hallway. To your north is a door labeled "Orca's Room", Room 301, and to your west there is a hallway.

* * *

>w
Elevator Floor 3
You are in an elevator room. The elevator can go down but not up. To your south is a door labeled "Pool", and to your east is a door labeled "Dining Room and Rooms".

>s
Outdoor Balcony
A large balcony. To the east is the Dining Room, and to the North is the Elevator.

You can see a Pool here.

* * *

>e
Dining Room
You are in a large area with a bunch of round tables. To your north is a hallway, and to your west is a door to the pool.

Orca is sitting at one of the tables.

Fladibearius is sitting at another table.

>n
Hallway Outside Room 300
You are in a hallway. To your north is a door labeled "Tiggery's Room", Room 300, and to your east there is a hallway, to your west is an elevator, and to your south is the dining room.

>w
Elevator Floor 3
You are in an elevator room. The elevator can go down but not up. To your south is a door labeled "Pool", and to your east is a door labeled "Dining Room and Rooms".

* * *

>e
Hallway Outside Room 200
You are in a hallway. To your north is a door labeled "Sylvia's room", Room 200, and to your east there is a hallway, and to your west there is an elevator.

>n
Sylvia's Room
You are in a pink bedroom with a bed and a closet, and an oven that smells like chocolate cake. To your south is the exit.

Sylvia is yet again asleep.

>wake sylvia
(Sylvia) STOP IT DAVE!!!

Sylvia fell asleep again.

>give chocolate to sylvia
(Sylvia) Hmmmmmm? Oh, CHOCOLATE!!!!!!
(Sylvia) Ok, I guess I should give you your magic crystal now.

>i
You are carrying:
  Pink Magic Crystal
  Sushi
  Green Magic Crystal
  Small Key
  Floatie

>s
Hallway Outside Room 200
You are in a hallway. To your north is a door labeled "Sylvia's room", Room 200, and to your east there is a hallway, and to your west there is an elevator.

* * *

>e
Hallway Outside Dave's Room
You are in a hallway. To your north is a door labeled "Dave's room", Room 201, and to your east and west the hallway continues.

>n
Dave's Bedroom
You are in a small bedroom with a bed and a closet. To your south is the exit.

You can see a Closet (empty) here.

>s
Hallway Outside Dave's Room
You are in a hallway. To your north is a door labeled "Dave's room", Room 201, and to your east and west the hallway continues.

>e
Hallway Outside Room 202
You are in a hallway. To your north is a door labeled "Swimmy's Room", Room 202, and to your west there is a hallway.

>n
Swimmy's room
You are in a bedroom with ocean wallpaper, a bed, a couch, and a bunch of tools on top of a desk.

Swimmy is sitting on the couch reading a book.

>talk to swimmy
(Swimmy) Good luck Dave!

* * *

>w
Hallway Outside Room 200
You are in a hallway. To your north is a door labeled "Sylvia's room", Room 200, and to your east there is a hallway, and to your west there is an elevator.

I beg your pardon?

>i
You are carrying:
  Pink Magic Crystal
  Sushi
  Green Magic Crystal
  Small Key
  Floatie

>s
You can't go that way.

>w
Elevator Floor 2
You are in an elevator room. The elevator can go up or down. To your east is a hallway.

* * *

>u
Elevator Floor 3
You are in an elevator room. The elevator can go down but not up. To your south is a door labeled "Pool", and to your east is a door labeled "Dining Room and Rooms".

>s
Outdoor Balcony
A large balcony. To the east is the Dining Room, and to the North is the Elevator.

You can see a Pool here.

* * *

>e
Dining Room
You are in a large area with a bunch of round tables. To your north is a hallway, and to your west is a door to the pool.

Orca is sitting at one of the tables.

Fladibearius is sitting at another table.

>give floatie to orca
Orca doesn't seem interested.

>n
Hallway Outside Room 300
You are in a hallway. To your north is a door labeled "Tiggery's Room", Room 300, and to your east there is a hallway, to your west is an elevator, and to your south is the dining room.

* * *

>e
Hallway Outside Room 301
You are in a hallway. To your north is a door labeled "Orca's Room", Room 301, and to your west there is a hallway.

>e
Hallway Outside Room 302
You are in a hallway. To your north is a door labeled "Fladibearius' Room", Room 302, and to your west there is a hallway.

* * *

>n
(first opening Fladibearius' door)
It seems to be locked.

>w
Hallway Outside Room 301
You are in a hallway. To your north is a door labeled "Orca's Room", Room 301, and to your west there is a hallway.

* * *

>e
Hallway Outside Room 102
You are in a hallway. To your north is a door labeled "Big Giraffe's Room", Room 102, and to your east and west there a hallway.

>n
Big Giraffe's room
You are in a bedroom with grassy wallpaper, a bed, a couch, and photos on the wall.

Big Giraffe is sewing something.

>talk to big
(Big Giraffe)
Try talking to Little Giraffe.

* * *

>w
Hallway Outside Room 101
You are in a hallway. To your north is a door labeled "Little Giraffe's Room", Room 101, and to your east and west there is more hallway.

>n
Little Giraffe's room
You are in a bedroom with grassy wallpaper, a bed, a couch, and a desk.

Little Giraffe is sitting on the couch watching TV.

>talk to little
(Little Giraffe)
(Little Giraffe) I hope you find it!

>give floatie to little
(Little Giraffe)
(Little Giraffe) Thanks! Where was it?
(You) It was at the pool, obviously.
(Little Giraffe) Oh. Well, you can have this pogo stick!

 Little Giraffe cheers at something on the TV.

>i
You are carrying:
  Pogo Stick
  Pink Magic Crystal
  Sushi
  Green Magic Crystal
  Small Key

 A loud explosion comes from the TV.

>s
Hallway Outside Room 101
You are in a hallway. To your north is a door labeled "Little Giraffe's Room", Room 101, and to your east and west there is more hallway.

>w
Hallway Outside Room 100
You are in a hallway. To your north is a door labeled "Bear Bear's Room", Room 100, and to your east there is a hallway, and to your west there is an elevator.

* * *

>s
You can't go that way.

>e
Hallway Outside Room 101
You are in a hallway. To your north is a door labeled "Little Giraffe's Room", Room 101, and to your east and west there is more hallway.

* * *

>w
Elevator Floor 1
You are in an elevator room. The elevator can go up but not down. To your east is a hallway, and to your south is a door labeled "Commons".

I beg your pardon?

>s
Commons
You are in a nicely furnished room with a fireplace and some couches and books on the shelf. To your north is the elevator, and to your east is the lobby.

>e
Lobby
You are in a entrance lobby. To your west is the commons, and to your south is the exit into the land of Lhivhingrum. For some reason, no one is at the check-in desk. There is a sign on the wall.

* * *

>s
Lower Central Bukshelv Cliff
You are at the base of the most enormous cliff imaginable. It is so steep, how on earth can you get up there? The base of the cliff stretches on to your east and west, to your south is the Plains of Car Pet.

I beg your pardon?

I beg your pardon?

>w
Lower West Bukshelv Cliff
You are at the base of the most enormous cliff imaginable. It is so steep, how on earth can you get up there? The base of the cliff stretches on to your east.

You see a giant bull who seems to enjoy sitting at the base of this majestic cliff.

* * *

>talk to bull
(Benny the Bull) I heard that there's a magic crystal up there, but it's too steep for me.

>climb
What do you want to climb?

>bounce
You can't see any such thing.

>u
BOING! you bounce up the Cliff with your pogo stick.

Upper West Bukshelv Cliff
You are at the top of the world, it feels like. To your east the top of the cliff continues, and below you is the lower slopes of the cliff.

>w
You can't go that way.

>e
Bukshelv Cliff Summit
You are at the top of the world, it feels like. To your east and west the top of the cliff continues, and below you is the lower slopes of the cliff. You can see a large chunk of rock on the ground.

Godzilla is standing at the top, enjoying the view.

>talk to godzill
You can't see any such thing.

>talk to godzilla
(Godzilla) Why do you need magic powers if you have a view like this?

>talk to godzilla
(Godzilla) Why do you need magic powers if you have a view like this?

>look rock
A large chunk of rock. Maybe something is inside?

>look inside rock
You find nothing of interest.

>move rock
Nothing obvious happens.

>take rock
You don't need this rock, but maybe you need something inside it?

>break rock
You hack open the rock, revealing a blue glowing chunk of crystal.

>take crystal
(Blue Magic Crystal)
Taken.

>i
You are carrying:
  Blue Magic Crystal
  Pogo Stick
  Pink Magic Crystal
  Sushi
  Green Magic Crystal
  Small Key

>e
Upper East Bukshelv Cliff
You are at the top of the world, it feels like. To your west the top of the cliff continues, and below you is the lower slopes of the cliff.

>w
Bukshelv Cliff Summit
You are at the top of the world, it feels like. To your east and west the top of the cliff continues, and below you is the lower slopes of the cliff. You can see a large blue Magic Crystal on the ground.

Godzilla is standing at the top, enjoying the view.

>w
Upper West Bukshelv Cliff
You are at the top of the world, it feels like. To your east the top of the cliff continues, and below you is the lower slopes of the cliff.

>w
You can't go that way.

>s
You can't go that way.

>d
Lower West Bukshelv Cliff
You are at the base of the most enormous cliff imaginable. It is so steep, how on earth can you get up there? The base of the cliff stretches on to your east.

You see a giant bull who seems to enjoy sitting at the base of this majestic cliff.

>d
You can't go that way.

>e
Lower Central Bukshelv Cliff
You are at the base of the most enormous cliff imaginable. It is so steep, how on earth can you get up there? The base of the cliff stretches on to your east and west, to your south is the Plains of Car Pet.

* * *

>n
South Plains of Car Pet
You are in a desolate wasteland, and the ground is striped with red and white. To your north the plains continue, to your east is the Hills of Kauch and to your south is the enourmous Bukshelv Cliff.

>n
North Plains of Car Pet
You are in a desolate wasteland, and the ground is striped with red and white. To your south the plains continue, to your west is Mount Pyanno, and to your north is the entrance to SPICH.

* * *

>n
Lobby
You are in a entrance lobby. To your west is the commons, and to your south is the exit into the land of Lhivhingrum. For some reason, no one is at the check-in desk. There is a sign on the wall.

>n
You can't go that way.

>w
Commons
You are in a nicely furnished room with a fireplace and some couches and books on the shelf. To your north is the elevator, and to your east is the lobby.

* * *

>e
Lobby
You are in a entrance lobby. To your west is the commons, and to your south is the exit into the land of Lhivhingrum. For some reason, no one is at the check-in desk. There is a sign on the wall.

>n
You can't go that way.

>e
You can't go that way.

>e
You can't go that way.

* * *

>n
You can't go that way.

>lok
That's not a verb I recognise.

>look
Lobby
You are in a entrance lobby. To your west is the commons, and to your south is the exit into the land of Lhivhingrum. For some reason, no one is at the check-in desk. There is a sign on the wall.

>l
Lobby
You are in a entrance lobby. To your west is the commons, and to your south is the exit into the land of Lhivhingrum. For some reason, no one is at the check-in desk. There is a sign on the wall.

>w
Commons
You are in a nicely furnished room with a fireplace and some couches and books on the shelf. To your north is the elevator, and to your east is the lobby.

* * *

>e
Hallway Outside Room 103
You are in a hallway. To your north is a door labeled "Kelp and Seaweed's Room", Room 103, and to your west there a hallway.

>w
Hallway Outside Room 102
You are in a hallway. To your north is a door labeled "Big Giraffe's Room", Room 102, and to your east and west there a hallway.

* * *

>e
Hallway Outside Room 200
You are in a hallway. To your north is a door labeled "Sylvia's room", Room 200, and to your east there is a hallway, and to your west there is an elevator.

>e
Hallway Outside Dave's Room
You are in a hallway. To your north is a door labeled "Dave's room", Room 201, and to your east and west the hallway continues.

>e
Hallway Outside Room 202
You are in a hallway. To your north is a door labeled "Swimmy's Room", Room 202, and to your west there is a hallway.

* * *

>n
Swimmy's room
You are in a bedroom with ocean wallpaper, a bed, a couch, and a bunch of tools on top of a desk.

Swimmy is sitting on the couch reading a book.

>talk to swimmy
You did it Dave! Now we can get your powers back!
Swimmy places all the crystals onto your horn.
Suddenly, you feel normal again, like if your foot was asleep and then came back. 

 You go out onto the balcony and celebrate by launching fireworks from your horn.

    *** Congratulations, Dave! ***

Would you like to RESTART, RESTORE a saved game, QUIT or UNDO the last command?

* * *

>open closet
You open the Closet.

>s
(first opening Dave's door)

Hallway Outside Dave's Room
You are in a hallway. To your north is a door labeled "Dave's room", Room 201, and to your east and west the hallway continues.

>w
Hallway Outside Room 200
You are in a hallway. To your north is a door labeled "Sylvia's room", Room 200, and to your east there is a hallway, and to your west there is an elevator.

You can hear snores from under the door.

>n
(first opening Sylvia's door)
It seems to be locked.

You can hear snores from under the door.

>w
Elevator Floor 2
You are in an elevator room. The elevator can go up or down. To your east is a hallway.

>d
Hmm... maybe I should go talk to some people before I leave.

>look
Elevator Floor 2
You are in an elevator room. The elevator can go up or down. To your east is a hallway.

>e
Hallway Outside Room 200
You are in a hallway. To your north is a door labeled "Sylvia's room", Room 200, and to your east there is a hallway, and to your west there is an elevator.

You can hear snores from under the door.

>e
Hallway Outside Dave's Room
You are in a hallway. To your north is a door labeled "Dave's room", Room 201, and to your east and west the hallway continues.

* * *

>n
(first opening Swimmy's door)

Swimmy's room
You are in a bedroom with ocean wallpaper, a bed, a couch, and a bunch of tools on top of a desk.

Swimmy is sitting on the couch reading a book.

>talk
(to Swimmy)
(Swimmy) Hi Dave, what is it?
(You) I lost my magic powers this morning.
(Swimmy) Oh no!
He pauses and looks something up on his computer.
(Swimmy) Apparently you can get them back, you just need to find 3 magic crystals! Maybe you can find them. Look around! And if you find them, make sure to bring them back to me.

>look
Swimmy's room
You are in a bedroom with ocean wallpaper, a bed, a couch, and a bunch of tools on top of a desk.

Swimmy is sitting on the couch reading a book.

>s
Hallway Outside Room 202
You are in a hallway. To your north is a door labeled "Swimmy's Room", Room 202, and to your west there is a hallway.

* * *

>w
Hallway Outside Dave's Room
You are in a hallway. To your north is a door labeled "Dave's room", Room 201, and to your east and west the hallway continues.

>w
Hallway Outside Room 200
You are in a hallway. To your north is a door labeled "Sylvia's room", Room 200, and to your east there is a hallway, and to your west there is an elevator.

You can hear snores from under the door.

>w
Elevator Floor 2
You are in an elevator room. The elevator can go up or down. To your east is a hallway.

* * *

>s
Commons
You are in a nicely furnished room with a fireplace and some couches and books on the shelf. To your north is the elevator, and to your east is the lobby.

>take books
That's hardly portable.

>e
Lobby
You are in a entrance lobby. To your west is the commons, and to your south is the exit into the land of Lhivhingrum. For some reason, no one is at the check-in desk. There is a sign on the wall.

>look at sign
You can't see any such thing.

>read sign
You can't see any such thing.

>w
Commons
You are in a nicely furnished room with a fireplace and some couches and books on the shelf. To your north is the elevator, and to your east is the lobby.

* * *

>e
Hallway Outside Room 100
You are in a hallway. To your north is a door labeled "Bear Bear's Room", Room 100, and to your east there is a hallway, and to your west there is an elevator.

>n
(first opening BearBear's door)

BearBear's room
You are in a bedroom with honey wallpaper, a bed, a couch, a TV, and a bunch of books on top of a shelf.

Bear Bear is sitting on the couch watching basketball.

>talk
(to BearBear)
(Bear Bear) What is it, Dave?
(You) Oh, I lost my powers this morning...
(Bear Bear) Hmmm... I have something that might help you, but could you find me a honey cake from the kitchen first?
(You) Ok, I will bring one back here.

Bear Bear yells at the TV.

>e
You can't go that way.

>s
Hallway Outside Room 100
You are in a hallway. To your north is a door labeled "Bear Bear's Room", Room 100, and to your east there is a hallway, and to your west there is an elevator.

* * *

>e
Hallway Outside Room 101
You are in a hallway. To your north is a door labeled "Little Giraffe's Room", Room 101, and to your east and west there is more hallway.

>n
(first opening Little Giraffe's door)

Little Giraffe's room
You are in a bedroom with grassy wallpaper, a bed, a couch, and a desk.

Little Giraffe is sitting on the couch watching TV.

>talk
(to Little Giraffe)
(Little Giraffe) What is it, Dave? Did you bring me candy?
(You) No, but I lost my powers this morning...
(Little Giraffe) Maybe I have something that will help. If you find my pool floatie I will give you one of my special toys!
(You) Ok, I will find it!.

>look at TV
Little Giraffe is watching Muffy the Stuffie. This episode is about Muffy trying to blow up the car so she doesn't have to go to the vet.

 A loud explosion comes from the TV.

>s
Hallway Outside Room 101
You are in a hallway. To your north is a door labeled "Little Giraffe's Room", Room 101, and to your east and west there is more hallway.

* * *

>e
Hallway Outside Room 102
You are in a hallway. To your north is a door labeled "Big Giraffe's Room", Room 102, and to your east and west there a hallway.

>n
(first opening Big Giraffe's door)

Big Giraffe's room
You are in a bedroom with grassy wallpaper, a bed, a couch, and photos on the wall.

Big Giraffe is sewing something.

>talk
(to Big Giraffe)
(Big Giraffe) Hi Dave.
(You) I lost my powers this morning!
(Big Giraffe) Oh no! Sorry, but there is not much I can do. Try talking to Little Giraffe.
(You) I already did!
(Big Giraffe) Oh, then maybe she has something for you. Good luck Dave!

>s
Hallway Outside Room 102
You are in a hallway. To your north is a door labeled "Big Giraffe's Room", Room 102, and to your east and west there a hallway.

>e
Hallway Outside Room 103
You are in a hallway. To your north is a door labeled "Kelp and Seaweed's Room", Room 103, and to your west there a hallway.

>n
(first opening Kelpweed's door)

Kelpweed's room
You are in a bedroom with ocean wallpaper, two beds, a couch, and a desk.

Kelp is reading on the couch.

>talk
(to Kelp)
(Kelp) Hi Dave.
(You) I lost my powers this morning! I need magic crystals!
(Kelp) Oh no! Well, you're in luck, because I have a way to make magic crystals! The only problem is that I need river water, and I lost my bucket. Also, I forgot where the river is.
(You) I'll get some river water for you!
(Kelp) I will make a crystal for you then!

>s
Hallway Outside Room 103
You are in a hallway. To your north is a door labeled "Kelp and Seaweed's Room", Room 103, and to your west there a hallway.

* * *

>s
Outdoor Balcony
A large balcony. To the east is the Dining Room, and to the North is the Elevator.

You can see a Pool and Bucket here.

>take bucket
Taken.

>look at pool
The sun reflects off the water, and you can see something floating on the water. It appears to be a giraffe floatie.

>take floatie
Taken.

>e
Dining Room
You are in a large area with a bunch of round tables. To your north is a hallway, and to your west is a door to the pool.

Orca is sitting at one of the tables.

Fladibearius is sitting at another table.

>talk
Whom do you want to talk to?

>orca
(Orca) Swimmy told me what happened, Dave.
(You) Can you help me?
(Orca) What do you need?
(You) Um, nothing.
(Orca) Well, have some sushi!
You eat sushi with Orca.
(Orca) Bye Dave!

>talk
Whom do you want to talk to?

>fladibearius
(Fladibearius) Hi Dave, I heard about what happened. I can't really help you, sorry!
(You) That's fine Fladibearius. What are you eating?
(Fladibearius) This is honey cake. Do you want any?
(Yes or No)

>yes
(Fladibearius) Here you are!

>i
You are carrying:
  Honey Cake
  Giraffe Floatie
  Bucket

>n
Hallway Outside Room 300
You are in a hallway. To your north is a door labeled "Tiggery's Room", Room 300, and to your east there is a hallway, to your west is an elevator, and to your south is the dining room.

* * *

>n
(first opening Tiggery's door)

Tiggery's Room
You are in a bedroom with orange striped wallpaper, a bed, a couch, a desk, and tools hanging on the wall.

Tiggery is making something with his tools.

>talk
(to Tiggery)
(Tiggery) What's going on, Dave?
(You) I lost my powers this morning!
(Tiggery) That's not good! Swimmy probably already told you, but you need apparently 3 magic crystals.
(You) I know!
(Tiggery) Anyway, I don't have anything to help you with, sorry. If you could bring me some sushi that would be good though!

>s
Hallway Outside Room 300
You are in a hallway. To your north is a door labeled "Tiggery's Room", Room 300, and to your east there is a hallway, to your west is an elevator, and to your south is the dining room.

* * *

>talk to orca
(Orca) Hi again! Do you need anything?
(You) Could I have some sushi to take to Tiggery?
(Orca) Sure! Here you go! Bye!

>save
Save failed.

>i
You are carrying:
  Sushi
  Honey Cake
  Giraffe Floatie
  Bucket

>n
Hallway Outside Room 300
You are in a hallway. To your north is a door labeled "Tiggery's Room", Room 300, and to your east there is a hallway, to your west is an elevator, and to your south is the dining room.

* * *

>n
Tiggery's Room
You are in a bedroom with orange striped wallpaper, a bed, a couch, a desk, and tools hanging on the wall.

Tiggery is making something with his tools.

>give sushi
(to Tiggery)
(Tiggery) Oh wow! Thank you!
(Tiggery) I just realized, I can give you this Key. I don't know why you would want it, but here you go!

>i
You are carrying:
  Sylvia's Key
  Honey Cake
  Giraffe Floatie
  Bucket

>s
Hallway Outside Room 300
You are in a hallway. To your north is a door labeled "Tiggery's Room", Room 300, and to your east there is a hallway, to your west is an elevator, and to your south is the dining room.

>e
Hallway Outside Room 301
You are in a hallway. To your north is a door labeled "Orca's Room", Room 301, and to your east and west there is hallway.

>n
(first opening Orca's door)
It seems to be locked.

>e
Hallway Outside Room 302
You are in a hallway. To your north is a door labeled "Fladibearius' Room", Room 302, and to your west there is a hallway.

* * *

>n
(first opening Fladibearius' door)
It seems to be locked.

>w
Hallway Outside Room 301
You are in a hallway. To your north is a door labeled "Orca's Room", Room 301, and to your east and west there is hallway.

>w
Hallway Outside Room 300
You are in a hallway. To your north is a door labeled "Tiggery's Room", Room 300, and to your east there is a hallway, to your west is an elevator, and to your south is the dining room.

* * *

>d
Elevator Floor 2
You are in an elevator room. The elevator can go up or down. To your east is a hallway.

>e
Hallway Outside Room 200
You are in a hallway. To your north is a door labeled "Sylvia's room", Room 200, and to your east there is a hallway, and to your west there is an elevator.

You can hear snores from under the door.

>n
(first opening Sylvia's door)
It seems to be locked.

You can hear snores from under the door.

>unlock door
What do you want to unlock Sylvia's door with?

>key
You unlock Sylvia's door.

You can hear snores from under the door.

>n
(first opening Sylvia's door)

Sylvia's Room
You are in a pink bedroom with a bed and a closet, and an oven that smells like chocolate cake. To your south is the exit.

Sylvia is snoring loudly on the bed.

>wake sylvia up
Sylvia wakes up.
(Sylvia) What is going on???
(You) I lost all of my powers! Do you have a magic crystal?
(Sylvia) Yes, but I will give you one only if you bring me chocolate.

Sylvia fell asleep again.

>e
You can't go that way.

>s
Hallway Outside Room 200
You are in a hallway. To your north is a door labeled "Sylvia's room", Room 200, and to your east there is a hallway, and to your west there is an elevator.

You can hear snores from under the door.

>w
Elevator Floor 2
You are in an elevator room. The elevator can go up or down. To your east is a hallway.

* * *

>n
BearBear's room
You are in a bedroom with honey wallpaper, a bed, a couch, a TV, and a bunch of books on top of a shelf.

Bear Bear is sitting on the couch watching basketball.

>give cake
(to BearBear)
(Bear Bear) Oh wow! Thank you!
(Bear Bear) Thanks! Hmm, what can I give you? Oh! I have some M&Ms. Here you go!

>i
You are carrying:
  Chocolate Candies
  Sylvia's Key
  Giraffe Floatie
  Bucket

>s
Hallway Outside Room 100
You are in a hallway. To your north is a door labeled "Bear Bear's Room", Room 100, and to your east there is a hallway, and to your west there is an elevator.

* * *

>e
Hallway Outside Room 101
You are in a hallway. To your north is a door labeled "Little Giraffe's Room", Room 101, and to your east and west there is more hallway.

>n
Little Giraffe's room
You are in a bedroom with grassy wallpaper, a bed, a couch, and a desk.

Little Giraffe is sitting on the couch watching TV.

 Little Giraffe cheers at something on the TV.

>give floatie
(to Little Giraffe)
(Little Giraffe) Thanks! Where was it?
(You) It was at the pool, obviously.
(Little Giraffe) Oh. Well, you can have this pogo stick!

>i
You are carrying:
  Pogo Stick
  Chocolate Candies
  Sylvia's Key
  Bucket

 A loud explosion comes from the TV.

>s
Hallway Outside Room 101
You are in a hallway. To your north is a door labeled "Little Giraffe's Room", Room 101, and to your east and west there is more hallway.

* * *

>w
Elevator Floor 1
You are in an elevator room. The elevator can go up but not down. To your east is a hallway, and to your south is a door labeled "Commons".

>d
You can't go that way.

>e
Hallway Outside Room 100
You are in a hallway. To your north is a door labeled "Bear Bear's Room", Room 100, and to your east there is a hallway, and to your west there is an elevator.

>w
Elevator Floor 1
You are in an elevator room. The elevator can go up but not down. To your east is a hallway, and to your south is a door labeled "Commons".

* * *

>s
North Plains of Car Pet
You are in a desolate wasteland, and the ground is striped with red and white. To your south the plains continue, to your west is Mount Pyanno, and to your north is the entrance to SPICH.

>w
Lower Mount Pyanno
You are on the lower base of a high mountain. The mountain is made of some sort of black rock. The Mountain continues to your west.

* * *

>w
Upper Mount Pyanno
You are near the peak of Mount Pyanno. It is too steep to fully summit, though.

>e
Lower Mount Pyanno
You are on the lower base of a high mountain. The mountain is made of some sort of black rock. The Mountain continues to your west.

* * *

>e
North Plains of Car Pet
You are in a desolate wasteland, and the ground is striped with red and white. To your south the plains continue, to your west is Mount Pyanno, and to your north is the entrance to SPICH.

>s
South Plains of Car Pet
You are in a desolate wasteland, and the ground is striped with red and white. To your north the plains continue, to your east is the Hills of Kauch, where you can see the Kauch River, and to your south is the enourmous Bukshelv Cliff.

>e
Hills of Kauch
You are on some navy blue hills and to your east is a view that seems to go on forever. To your west is the South Plains of Car Pet. 

 You are at the edge of a large rushing river, the Kauch River.

>use bucket
(Bucket)
You fill the Bucket with water from the river.

>w
South Plains of Car Pet
You are in a desolate wasteland, and the ground is striped with red and white. To your north the plains continue, to your east is the Hills of Kauch, where you can see the Kauch River, and to your south is the enourmous Bukshelv Cliff.

>s
Lower Central Bukshelv Cliff
You are at the base of the most enormous cliff imaginable. It is so steep, how on earth can you get up there? The base of the cliff stretches on to your east and west, to your south is the Plains of Car Pet.

>up
BOING! you bounce up the Cliff with your pogo stick.

Bukshelv Cliff Summit
You are at the top of the world, it feels like. To your east and west the top of the cliff continues, and below you is the lower slopes of the cliff. You can see a large chunk of rock on the ground.

Godzilla is standing at the top, enjoying the view.

>talk
(to Godzilla)
(Godzilla) Why do you need magic powers if you have a view like this?

>look at rock
A large chunk of rock. Maybe something is inside?

>break rock
You hack open the rock, revealing a blue glowing chunk of crystal.

>take
(Godzilla)
I don't suppose Godzilla would care for that.

>take crystal
Taken.

>i
You are carrying:
  Blue Magic Crystal
  Bucket of River Water
  Pogo Stick
  Chocolate Candies
  Sylvia's Key

>d
Lower Central Bukshelv Cliff
You are at the base of the most enormous cliff imaginable. It is so steep, how on earth can you get up there? The base of the cliff stretches on to your east and west, to your south is the Plains of Car Pet.

>n
South Plains of Car Pet
You are in a desolate wasteland, and the ground is striped with red and white. To your north the plains continue, to your east is the Hills of Kauch, where you can see the Kauch River, and to your south is the enourmous Bukshelv Cliff.

>n
North Plains of Car Pet
You are in a desolate wasteland, and the ground is striped with red and white. To your south the plains continue, to your west is Mount Pyanno, and to your north is the entrance to SPICH.

* * *

>e
Hallway Outside Room 103
You are in a hallway. To your north is a door labeled "Kelp and Seaweed's Room", Room 103, and to your west there a hallway.

>n
Kelpweed's room
You are in a bedroom with ocean wallpaper, two beds, a couch, and a desk.

Kelp is reading on the couch.

>give bucket
(to Kelp)
(Kelp) Oh, you found it! Nice.
Kelp puts it in a pot with a bunch of other ingredients, and it bubbles and pops.
(Kelp) Here you go!

>i
You are carrying:
  Green Magic Crystal
  Blue Magic Crystal
  Pogo Stick
  Chocolate Candies
  Sylvia's Key

>s
Hallway Outside Room 103
You are in a hallway. To your north is a door labeled "Kelp and Seaweed's Room", Room 103, and to your west there a hallway.

* * *

>u
Elevator Floor 2
You are in an elevator room. The elevator can go up or down. To your east is a hallway.

>e
Hallway Outside Room 200
You are in a hallway. To your north is a door labeled "Sylvia's room", Room 200, and to your east there is a hallway, and to your west there is an elevator.

You can hear snores from under the door.

>n
Sylvia's Room
You are in a pink bedroom with a bed and a closet, and an oven that smells like chocolate cake. To your south is the exit.

Sylvia is yet again asleep.

>give candys
You can't see any such thing.

>give candies
(to Sylvia)
(Sylvia) Hmmmmmm? Oh, CHOCOLATE!!!!!!
(Sylvia) Ok, I guess I should give you your magic crystal now.

>i
You are carrying:
  Pink Magic Crystal
  Green Magic Crystal
  Blue Magic Crystal
  Pogo Stick
  Sylvia's Key

>s
Hallway Outside Room 200
You are in a hallway. To your north is a door labeled "Sylvia's room", Room 200, and to your east there is a hallway, and to your west there is an elevator.

You can hear snores from under the door.

* * *

>w
Elevator Floor 2
You are in an elevator room. The elevator can go up or down. To your east is a hallway.

>e
Hallway Outside Room 200
You are in a hallway. To your north is a door labeled "Sylvia's room", Room 200, and to your east there is a hallway, and to your west there is an elevator.

You can hear snores from under the door.

* * *

>e
Hallway Outside Dave's Room
You are in a hallway. To your north is a door labeled "Dave's room", Room 201, and to your east and west the hallway continues.

I beg your pardon?

>e
Hallway Outside Room 202
You are in a hallway. To your north is a door labeled "Swimmy's Room", Room 202, and to your west there is a hallway.

* * *

>n
Swimmy's room
You are in a bedroom with ocean wallpaper, a bed, a couch, and a bunch of tools on top of a desk.

Swimmy is sitting on the couch reading a book.

>talk
(to Swimmy)
You did it Dave! Now we can get your powers back!
Swimmy places all the crystals onto your horn.
Suddenly, you feel normal again, like if your foot was asleep and then came back. 

 You go out onto the balcony and celebrate by launching fireworks from your horn.

    *** Congratulations, Dave! ***

Would you like to RESTART, RESTORE a saved game, QUIT or UNDO the last command?

>save
Please give one of the answers above.

Would you like to RESTART, RESTORE a saved game, QUIT or UNDO the last command?

>save
Please give one of the answers above.

Would you like to RESTART, RESTORE a saved game, QUIT or UNDO the last command?

* * *

>open closet
You open the Closet.

>south
(first opening Dave's door)

Hallway Outside Dave's Room
You are in a hallway. To your north is a door labeled "Dave's room", Room 201, and to your east and west the hallway continues.

>west
Hallway Outside Room 200
You are in a hallway. To your north is a door labeled "Sylvia's room", Room 200, and to your east there is a hallway, and to your west there is an elevator.

* * *

>north
(first opening Sylvia's door)
It seems to be locked.

>east
Hallway Outside Dave's Room
You are in a hallway. To your north is a door labeled "Dave's room", Room 201, and to your east and west the hallway continues.

* * *

>talk to swimmy
(Swimmy) Hi Dave, what is it?
(You) I lost my magic powers this morning.
(Swimmy) Oh no!
He pauses and looks something up on his computer.
(Swimmy) Apparently you can get them back, you just need to find 4 magic crystals! Maybe you can find them. Look around!

>look around
You can't see any such thing.

>south
Hallway Outside Room 202
You are in a hallway. To your north is a door labeled "Swimmy's Room", Room 202, and to your west there is a hallway.

* * *

>west
Hallway Outside Dave's Room
You are in a hallway. To your north is a door labeled "Dave's room", Room 201, and to your east and west the hallway continues.

>east
Hallway Outside Room 202
You are in a hallway. To your north is a door labeled "Swimmy's Room", Room 202, and to your west there is a hallway.

* * *

>north
(first opening BearBear's door)

BearBear's Room
You are in a bedroom with honey wallpaper, a bed, a couch, a TV, and a bunch of books on top of a shelf.

Bear Bear is sitting on the couch watching basketball.

>talk to bear bear
(Bear Bear) What is it, Dave?
(You) Oh, I lost my powers this morning...
(Bear Bear) Hmmm... I have something that might help you, but could you find me a honey cake from the kitchen first?
(You) Ok, I will bring one back here.

Bear Bear yells at the TV.

>south
Hallway Outside Room 100
You are in a hallway. To your north is a door labeled "Bear Bear's Room", Room 100, and to your east there is a hallway, and to your west there is an elevator.

* * *

>east
Hallway Outside Room 101
You are in a hallway. To your north is a door labeled "Little Giraffe's Room", Room 101, and to your east and west there is more hallway.

>north
(first opening Little Giraffe's door)

Little Giraffe's Room
You are in a bedroom with grassy wallpaper, a bed, a couch, a desk, and a bunch of books on top of a shelf.

Little Giraffe is sitting on the couch watching TV.

>talk to little giraffe
(Little Giraffe) What is it, Dave? Did you bring me candy?
(You) No, but I lost my powers this morning...
(Little Giraffe) Maybe I have something that will help. If you find my pool floatie I will give you one of my special toys!
(You) Ok, I will find it!.

 A loud explosion comes from the TV.

>south
Hallway Outside Room 101
You are in a hallway. To your north is a door labeled "Little Giraffe's Room", Room 101, and to your east and west there is more hallway.

>west
Hallway Outside Room 100
You are in a hallway. To your north is a door labeled "Bear Bear's Room", Room 100, and to your east there is a hallway, and to your west there is an elevator.

* * *

>up
Elevator Floor 3
You are in an elevator room. The elevator can go down but not up. To your south is a door labeled "Pool", and to your east is a door labeled "Dining Room and Rooms".

>east
Hallway Outside Room 300
You are in a hallway. To your north is a door labeled "Tiggery's Room", Room 300, and to your east there is a hallway, to your west is an elevator, and to your south is the dining room.

>south
Dining Room
You are in a large area with a bunch of round tables. To your north is a hallway, and to your west is a door to the pool.

Orca is sitting at one of the tables.

Fladibearius is sitting at another table.

>talk to orca
(Orca) Swimmy told me what happened, Dave.
(You) Can you help me?
(Orca) What do you need?
(You) Um, nothing.
(Orca) Well, have some sushi!
You eat sushi with Orca.
(Orca) Bye Dave!

>take orca
I don't suppose Orca would care for that.

>talk to fladibearius
(Fladibearius) Hi Dave, I heard about what happened. I can't really help you, sorry!
(You) That's fine Fladibearius. What are you eating?
(Fladibearius) This is honey cake. Do you want any?
(Yes or No)

* * *

>yes
(Fladibearius) Here you are!

>i
You are carrying:
  Honey Cake

>look
Dining Room
You are in a large area with a bunch of round tables. To your north is a hallway, and to your west is a door to the pool.

Orca is sitting at one of the tables.

Fladibearius is sitting at another table.

* * *

>w
Elevator Floor 3
You are in an elevator room. The elevator can go down but not up. To your south is a door labeled "Pool", and to your east is a door labeled "Dining Room and Rooms".

>down
Elevator Floor 2
You are in an elevator room. The elevator can go up or down. To your east is a hallway.

* * *

>down
Elevator Floor 1
You are in an elevator room. The elevator can go up but not down. To your east is a hallway, and to your south is a door labeled "Commons".

>e
Hallway Outside Room 100
You are in a hallway. To your north is a door labeled "Bear Bear's Room", Room 100, and to your east there is a hallway, and to your west there is an elevator.

>n
BearBear's Room
You are in a bedroom with honey wallpaper, a bed, a couch, a TV, and a bunch of books on top of a shelf.

Bear Bear is sitting on the couch watching basketball.

>give honey cake to bear bear
(Bear Bear) Oh wow! Thank you!
(Bear Bear) Thanks! Hmm, what can I give you? Oh! I have some M&Ms. Here you go!

Bear Bear yells at the TV.

>i
You are carrying:
  Chocolate Candies

Bear Bear yells at the TV.

>thanks
That's not a verb I recognise.

>south
Hallway Outside Room 100
You are in a hallway. To your north is a door labeled "Bear Bear's Room", Room 100, and to your east there is a hallway, and to your west there is an elevator.

* * *

>east
Hallway Outside Room 101
You are in a hallway. To your north is a door labeled "Little Giraffe's Room", Room 101, and to your east and west there is more hallway.

>east
Hallway Outside Room 102
You are in a hallway. To your north is a door labeled "Big Giraffe's Room", Room 102, and to your west there a hallway.

* * *

>talk to big giraffe
(Big Giraffe) Hi Dave.
(You) I lost my powers this morning!
(Big Giraffe) Oh no! Sorry, but there is not much I can do. Try talking to Little Giraffe.
(You) I already did!
(Big Giraffe) Oh, then maybe she has something for you. Good luck Dave!

>south
Hallway Outside Room 102
You are in a hallway. To your north is a door labeled "Big Giraffe's Room", Room 102, and to your west there a hallway.

>e
You can't go that way.

>w
Hallway Outside Room 101
You are in a hallway. To your north is a door labeled "Little Giraffe's Room", Room 101, and to your east and west there is more hallway.

* * *

>w
Elevator Floor 1
You are in an elevator room. The elevator can go up but not down. To your east is a hallway, and to your south is a door labeled "Commons".

>up
Elevator Floor 2
You are in an elevator room. The elevator can go up or down. To your east is a hallway.

* * *

>up
Elevator Floor 3
You are in an elevator room. The elevator can go down but not up. To your south is a door labeled "Pool", and to your east is a door labeled "Dining Room and Rooms".

>e
Hallway Outside Room 300
You are in a hallway. To your north is a door labeled "Tiggery's Room", Room 300, and to your east there is a hallway, to your west is an elevator, and to your south is the dining room.

>n
(first opening Tiggery's door)

Tiggery's Room
You are in a bedroom with orange striped wallpaper, a bed, a couch, a desk, and tools hanging on the wall.

Tiggery is making something with his tools.

>talk to tiggery
(Tiggery) What's going on, Dave?
(You) I lost my powers this morning!
(Tiggery) That's not good! Swimmy probably already told you, but you need apparently 4 magic crystals.
(You) I know!
(Tiggery) Anyway, I don't have anything to help you with, sorry. If you could bring me some sushi that would be good though!

>south
Hallway Outside Room 300
You are in a hallway. To your north is a door labeled "Tiggery's Room", Room 300, and to your east there is a hallway, to your west is an elevator, and to your south is the dining room.

* * *

>south
Dining Room
You are in a large area with a bunch of round tables. To your north is a hallway, and to your west is a door to the pool.

Orca is sitting at one of the tables.

Fladibearius is sitting at another table.

>talk to orca
(Orca) Hi again! Do you need anything?
(You) Could I have some sushi to take to Tiggery?
(Orca) Sure! Here you go! Bye!

* * *

>i
You are carrying:
  Small Key
  Chocolate Candies

>west
You can't go that way.

>south
Hallway Outside Room 300
You are in a hallway. To your north is a door labeled "Tiggery's Room", Room 300, and to your east there is a hallway, to your west is an elevator, and to your south is the dining room.

>west
Elevator Floor 3
You are in an elevator room. The elevator can go down but not up. To your south is a door labeled "Pool", and to your east is a door labeled "Dining Room and Rooms".

* * *

>down
Elevator Floor 2
You are in an elevator room. The elevator can go up or down. To your east is a hallway.

>east
Hallway Outside Room 200
You are in a hallway. To your north is a door labeled "Sylvia's room", Room 200, and to your east there is a hallway, and to your west there is an elevator.

>north
(first opening Sylvia's door)
It seems to be locked.

>unlock door
What do you want to unlock Sylvia's door with?

>key
You unlock Sylvia's door.

>n
(first opening Sylvia's door)

Sylvia's Room
You are in a pink bedroom with a bed and a closet, and an oven that smells like chocolate cake. To your south is the exit.

Sylvia is snoring loudly on the bed.

>move sylvia
Sylvia might not like that.

>wake sylvia up
Sylvia wakes up.
(Sylvia) What is going on???
(You) I lost all of my powers! Do you have a magic crystal?
(Sylvia) Yes, but I will give you one only if you bring me chocolate.

>give sylvia chocolate
(Sylvia) Hmmmmmm? Oh, CHOCOLATE!!!!!!
(Sylvia) Ok, I guess I should give you your magic crystal now.

>i
You are carrying:
  Pink Magic Crystal
  Small Key

* * *

You wake up in the morning and you are in your bedroom, but your magic powers are gone! Uh Oh...

Rainbow Dave's Journey
An Interactive Fiction by Liam Calahan
Release 1 / Serial number 220224 / Inform 7 build 6M62 (I6/v6.34 lib 6/12N) SD

Dave's Bedroom
You are in a small bedroom with a bed and a closet. To your south is the exit.

You can see a Closet (closed) here.

>purloin
(the Closet)
[Purloined.]

>s
(first opening Dave's door)

Hallway Outside Dave's Room
You are in a hallway. To your north is a door labeled "Dave's room", Room 201, and to your east and west the hallway continues.

* * *

>n
(first opening Swimmy's door)

Swimmy's Room
You are in a bedroom with ocean wallpaper, a bed, a couch, and a bunch of tools on top of a desk.

Swimmy is sitting on the couch reading a book.

>talk
(to Swimmy)
(Swimmy) Hi Dave, what is it?
(You) I lost my magic powers this morning.
(Swimmy) Oh no!
He pauses and looks something up on his computer.
(Swimmy) Apparently you can get them back, you just need to find 4 magic crystals! Maybe you can find them. Look around!

* * *

>w
Elevator Floor 2
You are in an elevator room. The elevator can go up or down. To your east is a hallway.

>up
Elevator Floor 3
You are in an elevator room. The elevator can go down but not up. To your west is a door labeled "Pool", and to your east is a door labeled "Dining Room and Rooms".

>e
Hallway Outside Room 300
You are in a hallway. To your north is a door labeled "Tiggery's Room", Room 300, and to your east there is a hallway, to your west is an elevator, and to your south is the dining room.

* * *

>n
(first opening Tiggery's door)

Tiggery's Room
You are in a bedroom with orange striped wallpaper, a bed, a couch, a desk, and tools hanging on the wall.

Tiggery is making something with his tools.

>purloin
(the Closet)
[Purloined.]

>purloin
(the Closet)
[Purloined.]

>i
You are carrying:
  a Closet (open but empty)

>purloin small key
[Purloined.]

>i
You are carrying:
  Small Key
  a Closet (open but empty)

>s
Hallway Outside Room 300
You are in a hallway. To your north is a door labeled "Tiggery's Room", Room 300, and to your east there is a hallway, to your west is an elevator, and to your south is the dining room.

>west
Elevator Floor 3
You are in an elevator room. The elevator can go down but not up. To your west is a door labeled "Pool", and to your east is a door labeled "Dining Room and Rooms".

>down
Elevator Floor 2
You are in an elevator room. The elevator can go up or down. To your east is a hallway.

* * *

>east
Hallway Outside Room 200
You are in a hallway. To your north is a door labeled "Sylvia's room", Room 200, and to your east there is a hallway, and to your west there is an elevator.

>use small key on door
That's not a verb I recognise.

>unlock door
What do you want to unlock Sylvia's door with?

>small key
That's unlocked at the moment.

>n
(first opening Sylvia's door)

Sylvia's Room
You are in a pink bedroom with a bed and a closet, and an oven that smells like chocolate cake. To your south is the exit.

Sylvia is snoring loudly on the bed.

>wake up sylvia
Sylvia wakes up.
(Sylvia) What is going on???
(You) I lost all of my powers! Do you have a magic crystal?
(Sylvia) I will give you one only if you bring me chocolate.

>look
Sylvia's Room
You are in a pink bedroom with a bed and a closet, and an oven that smells like chocolate cake. To your south is the exit.

Sylvia is trying to fall asleep but keeps thinking about chocolate.

>wake sylvia
Sylvia wakes up.
(Sylvia) What is going on???
(You) I lost all of my powers! Do you have a magic crystal?
(Sylvia) I will give you one only if you bring me chocolate.

* * *

You wake up in the morning and you are in your bedroom, but your magic powers are gone! Uh Oh...

Rainbow Dave's Journey
An Interactive Fiction by Liam Calahan
Release 1 / Serial number 220224 / Inform 7 build 6M62 (I6/v6.34 lib 6/12N) SD

Dave's Bedroom
You are in a small bedroom with a bed and a closet. To your south is the exit.

You can see a Closet (closed) here.

>purloin chocolate candies
[Purloined.]

>purloin key
[Purloined.]

>s
(first opening Dave's door)

Hallway Outside Dave's Room
You are in a hallway. To your north is a door labeled "Dave's room", Room 201, and to your east and west the hallway continues.

>w
Hallway Outside Room 200
You are in a hallway. To your north is a door labeled "Sylvia's room", Room 200, and to your east there is a hallway, and to your west there is an elevator.

* * *

>n
(first opening Sylvia's door)
It seems to be locked.

>unlock dor
You can't see any such thing.

>unlock door
What do you want to unlock Sylvia's door with?

* * *

>key
You unlock Sylvia's door.

>north
(first opening Sylvia's door)

Sylvia's Room
You are in a pink bedroom with a bed and a closet, and an oven that smells like chocolate cake. To your south is the exit.

Sylvia is snoring loudly on the bed.

>give chocolate
(to Sylvia)
Sylvia doesn't seem interested.

* * *

You wake up in the morning and you are in your bedroom, but your magic powers are gone! Uh Oh...

Rainbow Dave's Journey
An Interactive Fiction by Liam Calahan
Release 1 / Serial number 220224 / Inform 7 build 6M62 (I6/v6.34 lib 6/12N) SD

Dave's Bedroom
You are in a small bedroom with a bed and a closet. To your south is the exit.

You can see a Closet (closed) here.

>purloin crystal
[Purloined.]

>s
(first opening Dave's door)

Hallway Outside Dave's Room
You are in a hallway. To your north is a door labeled "Dave's room", Room 201, and to your east and west the hallway continues.

* * *

>n
(first opening Swimmy's door)

Swimmy's Room
You are in a bedroom with ocean wallpaper, a bed, a couch, and a bunch of tools on top of a desk.

Swimmy is sitting on the couch reading a book.

>w
You can't go that way.

>w
You can't go that way.

>s
Hallway Outside Room 202
You are in a hallway. To your north is a door labeled "Swimmy's Room", Room 202, and to your west there is a hallway.

>n
Swimmy's Room
You are in a bedroom with ocean wallpaper, a bed, a couch, and a bunch of tools on top of a desk.

Swimmy is sitting on the couch reading a book.

>talk
(to Swimmy)
(Swimmy) Hi Dave, what is it?
(You) I lost my magic powers this morning.
(Swimmy) Oh no!
He pauses and looks something up on his computer.
(Swimmy) Apparently you can get them back, you just need to find 4 magic crystals! Maybe you can find them. Look around!

* * *

>w
Elevator Floor 2
You are in an elevator room. The elevator can go up or down. To your east is a hallway.

>down
Elevator Floor 1
You are in an elevator room. The elevator can go up but not down. To your east is a hallway, and to your south is a door labeled "Commons".

>s
Commons
You are in a nicely furnished room with a fireplace and some couches and books on the shelf. To your north is the elevator, and to your east is the lobby.

>e
Lobby
You are in a entrance lobby. To your west is the commons, and to your south is the exit into the land of Lhivhingrum.

>south
North Plains of Car Pet
You are in a desolate wasteland, and the ground is striped with red and white. To your south the plains continue, to your west is Mount Pyanno, and to your north is the entrance to SPICH.

* * *

You wake up in the morning and you are in your bedroom, but your magic powers are gone! Uh Oh...

Rainbow Dave's Journey
An Interactive Fiction by Liam Calahan
Release 1 / Serial number 220224 / Inform 7 build 6M62 (I6/v6.34 lib 6/12N) SD

Dave's Bedroom
You are in a small bedroom with a bed and a closet. To your south is the exit.

You can see a Closet (closed) here.

>purloin every item
There seems to be no such object anywhere in the model world.

>purloin all items
There seems to be no such object anywhere in the model world.

>purloin everything
[Purloined.]
[Can't move Dave's Bedroom: it would contain itself.]
[Purloined.]
[Purloined.]
[Purloined.]
[Purloined.]
[Purloined.]
[Purloined.]
[Purloined.]
[Purloined.]
[Purloined.]
[Purloined.]
[Purloined.]
[Purloined.]
[Purloined.]
[Purloined.]
[Purloined.]
[Purloined.]
[Purloined.]
[Purloined.]
[Purloined.]
[Purloined.]
[Purloined.]
[Purloined.]
[Purloined.]
[Purloined.]
[Purloined.]
[Purloined.]
[Purloined.]
[Purloined.]
[Purloined.]
[Purloined.]
[Purloined.]
[Purloined.]
[Purloined.]
[Purloined.]
[Purloined.]
[Purloined.]
[Purloined.]
[Purloined.]
[Purloined.]
[Purloined.]
[Purloined.]
[Purloined.]
[Purloined.]
[Purloined.]
[Purloined.]
[Purloined.]
[Purloined.]
[Purloined.]
[Purloined.]
[Purloined.]
[Purloined.]
[Purloined.]
[Purloined.]
[Purloined.]
[Purloined.]
[Purloined.]
[Purloined.]
[Purloined.]
[Purloined.]
[Purloined.]
[Purloined.]
[Purloined.]
[Purloined.]
[Purloined.]
[Purloined.]
[Purloined.]
[Purloined.]
[Purloined.]
[Purloined.]
[Purloined.]
[Purloined.]
[Purloined.]
[Purloined.]
[Purloined.]
[Purloined.]
[Purloined.]
[Purloined.]
[Purloined.]

>up
That's not a verb I recognise.

>w
That's not a verb I recognise.

>e
That's not a verb I recognise.

>up
That's not a verb I recognise.

>i
You are carrying:
  the outside
  the inside
  the down
  the up
  the west
  the east
  the southwest
  the southeast
  the south
  the northwest
  the northeast
  the north
  Fladibearius' door
  Orca's door
  Tiggery's door
  Big Giraffe's door
  Little Giraffe's door
  BearBear's door
  Swimmy's door
  Sylvia's door
  Upper West Bukshelv Cliff (providing light)
  Upper East Bukshelv Cliff (providing light)
  Bukshelv Cliff Summit (providing light)
  Upper Bukshelv Cliff
  Benny the Bull
  Lower West Bukshelv Cliff (providing light)
  Lower East Bukshelv Cliff (providing light)
  Lower Central Bukshelv Cliff (providing light)
  Lower Bukshelv Cliff
  Upper Mount Pyanno (providing light)
  Lower Mount Pyanno (providing light)
  South Plains of Car Pet (providing light)
  North Plains of Car Pet (providing light)
  Lhivhingrum
  Fladibearius' Room (providing light)
  Hallway Outside Room 302 (providing light)
  a Pool
    Floatie
  Outdoor Balcony (providing light)
  Honey Cake
  Fladibearius
  Sushi
  Orca
  Dining Room (providing light)
  Orca's Room (providing light)
  Small Key
  Tiggery
  Tiggery's Room (providing light)
  Hallway Outside Room 301 (providing light)
  Hallway Outside Room 300 (providing light)
  Floor Three
  Commons (providing light)
  Lobby (providing light)
  Chocolate Candies
  BearBear
  BearBear's room (providing light)
  Big Giraffe
  Big Giraffe's room (providing light)
  Pogo Stick
  Little Giraffe
  Little Giraffe's room (providing light)
  Hallway Outside Room 102 (providing light)
  Hallway Outside Room 101 (providing light)
  Hallway Outside Room 100 (providing light)
  Floor One
  Elevator Floor 3 (providing light)
  Elevator Floor 1 (providing light)
  Elevator Floor 2 (providing light)
  Hallway Outside Room 202 (providing light)
  Hallway Outside Room 200 (providing light)
  Hallway Outside Dave's Room (providing light)
  Pink Magic Crystal
  Sylvia
  Sylvia's Room (providing light)
  Swimmy
  Swimmy's room (providing light)
  Floor Two
  Dave's door
  a Bed
  a Closet (closed)

Bear Bear yells at the TV.

 A loud explosion comes from the TV.

I beg your pardon?

* * *

You wake up in the morning and you are in your bedroom, but your magic powers are gone! Uh Oh...

Rainbow Dave's Journey
An Interactive Fiction by Liam Calahan
Release 1 / Serial number 220224 / Inform 7 build 6M62 (I6/v6.34 lib 6/12N) SD

Dave's Bedroom
You are in a small bedroom with a bed and a closet. To your south is the exit.

You can see a Closet (closed) here.

>purloin everything
[Purloined.]
[Can't move Dave's Bedroom: it would contain itself.]
[Purloined.]
[Purloined.]
[Purloined.]
[Purloined.]
[Purloined.]
[Purloined.]
[Purloined.]
[Purloined.]
[Purloined.]
[Purloined.]
[Purloined.]
[Purloined.]
[Purloined.]
[Purloined.]
[Purloined.]
[Purloined.]
[Purloined.]
[Purloined.]
[Purloined.]
[Purloined.]
[Purloined.]
[Purloined.]
[Purloined.]
[Purloined.]
[Purloined.]
[Purloined.]
[Purloined.]
[Purloined.]
[Purloined.]
[Purloined.]
[Purloined.]
[Purloined.]
[Purloined.]
[Purloined.]
[Purloined.]
[Purloined.]
[Purloined.]
[Purloined.]
[Purloined.]
[Purloined.]
[Purloined.]
[Purloined.]
[Purloined.]
[Purloined.]
[Purloined.]
[Purloined.]
[Purloined.]
[Purloined.]
[Purloined.]
[Purloined.]
[Purloined.]
[Purloined.]
[Purloined.]
[Purloined.]
[Purloined.]
[Purloined.]
[Purloined.]
[Purloined.]
[Purloined.]
[Purloined.]
[Purloined.]
[Purloined.]
[Purloined.]
[Purloined.]
[Purloined.]
[Purloined.]
[Purloined.]
[Purloined.]
[Purloined.]
[Purloined.]
[Purloined.]
[Purloined.]
[Purloined.]
[Purloined.]
[Purloined.]
[Purloined.]
[Purloined.]
[Purloined.]

>i
You are carrying:
  the outside
  the inside
  the down
  the up
  the west
  the east
  the southwest
  the southeast
  the south
  the northwest
  the northeast
  the north
  Fladibearius' door
  Orca's door
  Tiggery's door
  Big Giraffe's door
  Little Giraffe's door
  BearBear's door
  Swimmy's door
  Sylvia's door
  Upper West Bukshelv Cliff (providing light)
  Upper East Bukshelv Cliff (providing light)
  Bukshelv Cliff Summit (providing light)
  Upper Bukshelv Cliff
  Benny the Bull
  Lower West Bukshelv Cliff (providing light)
  Lower East Bukshelv Cliff (providing light)
  Lower Central Bukshelv Cliff (providing light)
  Lower Bukshelv Cliff
  Upper Mount Pyanno (providing light)
  Lower Mount Pyanno (providing light)
  South Plains of Car Pet (providing light)
  North Plains of Car Pet (providing light)
  Lhivhingrum
  Fladibearius' Room (providing light)
  Hallway Outside Room 302 (providing light)
  a Pool
    Floatie
  Outdoor Balcony (providing light)
  Honey Cake
  Fladibearius
  Sushi
  Orca
  Dining Room (providing light)
  Orca's Room (providing light)
  Small Key
  Tiggery
  Tiggery's Room (providing light)
  Hallway Outside Room 301 (providing light)
  Hallway Outside Room 300 (providing light)
  Floor Three
  Commons (providing light)
  Lobby (providing light)
  Chocolate Candies
  BearBear
  BearBear's room (providing light)
  Big Giraffe
  Big Giraffe's room (providing light)
  Pogo Stick
  Little Giraffe
  Little Giraffe's room (providing light)
  Hallway Outside Room 102 (providing light)
  Hallway Outside Room 101 (providing light)
  Hallway Outside Room 100 (providing light)
  Floor One
  Elevator Floor 3 (providing light)
  Elevator Floor 1 (providing light)
  Elevator Floor 2 (providing light)
  Hallway Outside Room 202 (providing light)
  Hallway Outside Room 200 (providing light)
  Hallway Outside Dave's Room (providing light)
  Pink Magic Crystal
  Sylvia
  Sylvia's Room (providing light)
  Swimmy
  Swimmy's room (providing light)
  Floor Two
  Dave's door
  a Bed
  a Closet (closed)

Bear Bear yells at the TV.

 A loud explosion comes from the TV.

* * *

You wake up in the morning and you are in your bedroom, but your magic powers are gone! Uh Oh...

Rainbow Dave's Journey
An Interactive Fiction by Liam Calahan
Release 1 / Serial number 220224 / Inform 7 build 6M62 (I6/v6.34 lib 6/12N) SD

Dave's Bedroom
You are in a small bedroom with a bed and a closet. To your south is the exit.

You can see a Closet (closed) here.

>purloin key
[Purloined.]

>purloin candies
[Purloined.]

>s
(first opening Dave's door)

Hallway Outside Dave's Room
You are in a hallway. To your north is a door labeled "Dave's room", Room 201, and to your east and west the hallway continues.

* * *

>n
(first opening Sylvia's door)
It seems to be locked.

>unlock door
What do you want to unlock Sylvia's door with?

* * *

>n
(first opening Sylvia's door)

Sylvia's Room
You are in a pink bedroom with a bed and a closet, and an oven that smells like chocolate cake. To your south is the exit.

Sylvia is snoring loudly on the bed.

>wake sylvia
Sylvia wakes up.
(Sylvia) What is going on???
(You) I lost all of my powers! Do you have a magic crystal?
(Sylvia) Yes, but I will give you one only if you bring me chocolate.

Sylvia fell asleep again.

>give chocolate
(to Sylvia)
(Sylvia) Hmmmmmm? Oh, CHOCOLATE!!!!!!
(Sylvia) Ok, I guess I should give you your magic crystal now.

>i
You are carrying:
  Pink Magic Crystal
  Small Key

>look at crystal
A small gem emitting a pink glow

* * *

You wake up in the morning and you are in your bedroom, but your magic powers are gone! Uh Oh...

Rainbow Dave's Journey
An Interactive Fiction by Liam Calahan
Release 1 / Serial number 220224 / Inform 7 build 6M62 (I6/v6.34 lib 6/12N) SD

Dave's Bedroom
You are in a small bedroom with a bed and a closet. To your south is the exit.

You can see a Closet (closed) here.

>purloin river
(Kauch River)
[Purloined.]

>purloin river water
[Purloined.]

>look at river
(Bucket of River Water)
A bucket filled to the brim with cold water from the Kauch River.

* * *

You wake up in the morning and you are in your bedroom, but your magic powers are gone! Uh Oh...

Rainbow Dave's Journey
An Interactive Fiction by Liam Calahan
Release 1 / Serial number 220224 / Inform 7 build 6M62 (I6/v6.34 lib 6/12N) SD

Dave's Bedroom
You are in a small bedroom with a bed and a closet. To your south is the exit.

You can see a Closet (closed) here.

>s
(first opening Dave's door)

Hallway Outside Dave's Room
You are in a hallway. To your north is a door labeled "Dave's room", Room 201, and to your east and west the hallway continues.

I beg your pardon?

* * *

>s
Commons
You are in a nicely furnished room with a fireplace and some couches and books on the shelf. To your north is the elevator, and to your east is the lobby.

>i
You are carrying nothing.

* * *

I beg your pardon?

>w
Hallway Outside Room 200
You are in a hallway. To your north is a door labeled "Sylvia's room", Room 200, and to your east there is a hallway, and to your west there is an elevator.

You can hear snores from under the door.

>z
Time passes.

You can hear snores from under the door.

>e
Hallway Outside Dave's Room
You are in a hallway. To your north is a door labeled "Dave's room", Room 201, and to your east and west the hallway continues.

* * *

>talk
(to Swimmy)
(Swimmy) Hi Dave, what is it?
(You) I lost my magic powers this morning.
(Swimmy) Oh no!
He pauses and looks something up on his computer.
(Swimmy) Apparently you can get them back, you just need to find 3 magic crystals! Maybe you can find them. Look around! And if you find them, make sure to bring them back to me.

>s
Hallway Outside Room 202
You are in a hallway. To your north is a door labeled "Swimmy's Room", Room 202, and to your west there is a hallway.

* * *

>s
(first opening Dave's door)

Hallway Outside Dave's Room
You are in a hallway. To your north is a door labeled "Dave's room", Room 201, and to your east and west the hallway continues.

>attack door
Ummm... you'll get kicked out of SPICH for that.

>break door
Ummm... you'll get kicked out of SPICH for that.

* * *

>e
Hallway Outside Room 202
You are in a hallway. To your north is a door labeled "Swimmy's Room", Room 202, and to your west there is a hallway.

>e
You can't go that way.

>n
Swimmy's Room
You are in a bedroom with ocean wallpaper, a bed, a couch, and a bunch of tools on top of a desk.

Swimmy is sitting on the couch reading a book.

>talk to swimmy
(Swimmy) Hi Dave, what is it?
(You) I lost my magic powers this morning.
(Swimmy) Oh no!
He pauses and looks something up on his computer.
(Swimmy) Apparently you can get them back, you just need to find 4 magic crystals! Maybe you can find them. Look around!

>s
Hallway Outside Room 202
You are in a hallway. To your north is a door labeled "Swimmy's Room", Room 202, and to your west there is a hallway.

* * *

>w
Elevator Floor 2
You are in an elevator room. The elevator can go up or down. To your east is a hallway.

>down
Hmm... maybe I should go talk to some people before I leave.

>e
Hallway Outside Room 200
You are in a hallway. To your north is a door labeled "Sylvia's room", Room 200, and to your east there is a hallway, and to your west there is an elevator.

* * *

>n
(first opening Swimmy's door)

Swimmy's room
You are in a bedroom with ocean wallpaper, a bed, a couch, and a bunch of tools on top of a desk.

Swimmy is sitting on the couch reading a book.

>look at swimmy
(Swimmy) Hi Dave!

* * *

>talk
(to Swimmy)
(Swimmy) Hi Dave, what is it?
(You) I lost my magic powers this morning.
(Swimmy) Oh no!
He pauses and looks something up on his computer.
(Swimmy) Apparently you can get them back, you just need to find 3 magic crystals! Maybe you can find them. Look around! And if you find them, make sure to bring them back to me.

I beg your pardon?

>s
Hallway Outside Room 202
You are in a hallway. To your north is a door labeled "Swimmy's Room", Room 202, and to your west there is a hallway.

* * *

>w
Elevator Floor 2
You are in an elevator room. The elevator can go up or down. To your east is a hallway.

>up
Elevator Floor 3
You are in an elevator room. The elevator can go down but not up. To your south is a door labeled "Pool", and to your east is a door labeled "Dining Room and Rooms".

>s
Outdoor Poolroom
A large outdoor pool. To the east is the Dining Room, and to the North is the Elevator.

>look at pool
The sun reflects off the water, and you can see something floating on the water. It appears to be a giraffe floatie.

* * *

>talk
(to Swimmy)
(Swimmy) Hi Dave, what is it?
(You) I lost my magic powers this morning.
(Swimmy) Oh no!
He pauses and looks something up on his computer.
(Swimmy) Apparently you can get them back, you just need to find 3 magic crystals! Maybe you can find them. Look around! And if you find them, make sure to bring them back to me.

>purloin blue
[Purloined.]

>purloin pink
[Purloined.]

>purloin green
[Purloined.]

>i
You are carrying:
  Green Magic Crystal
  Pink Magic Crystal
  Blue Magic Crystal

>talk to swimmy
TEST

>undo
Swimmy's room
[Previous turn undone.]

>undo
Swimmy's room
[Previous turn undone.]

>i
You are carrying:
  Blue Magic Crystal

>undo
Swimmy's room
[Previous turn undone.]

>i
You are carrying nothing.

>talk to swimmy
(Swimmy) Good luck Dave!

* * *

>talk
(to Swimmy)
(Swimmy) Hi Dave, what is it?
(You) I lost my magic powers this morning.
(Swimmy) Oh no!
He pauses and looks something up on his computer.
(Swimmy) Apparently you can get them back, you just need to find 3 magic crystals! Maybe you can find them. Look around! And if you find them, make sure to bring them back to me.

>purloin crystal
Which do you mean, Pink Magic Crystal, Green Magic Crystal or Blue Magic Crystal?

>all
[Purloined.]
[Purloined.]
[Purloined.]

>talk
(to Swimmy)
You did it Dave! Now we can get your powers back!
Swimmy places all the crystals onto your horn.
Suddenly, you feel normal again, like if your foot was asleep and then came back. 

 You go out onto the balcony and celebrate by launching fireworks from your horn.

    *** Congratulations, Dave! ***

Would you like to RESTART, RESTORE a saved game, QUIT or UNDO the last command?

* * *

>e
Hallway Outside Room 103
You are in a hallway. To your north is a door labeled "Kelp and Seaweed's Room", Room 103, and to your west there a hallway.

>n
(first opening Kelpweed's door)

Kelpweed's Room
You are in a bedroom with ocean wallpaper, two beds, a couch, and a desk.

Kelp is reading on the couch.

>look at bed
Which do you mean, Seaweed's Bed or Kelp's Bed?

>look at Seaweed's Bed
Seaweed is buried under the covers snoring loudly.

* * *

>wake seaweed
He is fast asleep. It seems mean to wake him up.

>talk to Kelp
(Kelp) Hi Dave.
(You) I lost my powers this morning! I need magic crystals!
(Kelp) Oh no! Well, you're in luck, because I have a way to make magic crystals! The only problem is that I need river water, and I lost my bucket. Also, I forgot where the river is.
(You) I'll get some river water for you!
(Kelp) I will make a crystal for you then!

>purloin river water
[Purloined.]

>i
You are carrying:
  Bucket of River Water

>give river waer
You can only do that to something animate.

>give river water to kelp
(Kelp) Oh, you found it! Nice.
Kelp puts it in a pot with a bunch of other ingredients, and it bubbles and pops.
(Kelp) Here you go!

>i
You are carrying:
  Green Magic Crystal

>restart
Are you sure you want to restart?

Please answer yes or no.

>yes
You wake up in the morning and you are in your bedroom, but your magic powers are gone! Uh Oh...

Rainbow Dave's Journey
An Interactive Fiction by Liam Calahan
Release 1 / Serial number 220223 / Inform 7 build 6M62 (I6/v6.34 lib 6/12N) SD

Dave's Bedroom
You are in a small bedroom with a bed and a closet. To your south is the exit.

You can see a Closet (closed) here.

>s
(first opening Dave's door)

Hallway Outside Dave's Room
You are in a hallway. To your north is a door labeled "Dave's room", Room 201, and to your east and west the hallway continues.

* * *

>n
(first opening Swimmy's door)

Swimmy's room
You are in a bedroom with ocean wallpaper, a bed, a couch, and a bunch of tools on top of a desk.

Swimmy is sitting on the couch reading a book.

>talk
(to Swimmy)
(Swimmy) Hi Dave, what is it?
(You) I lost my magic powers this morning.
(Swimmy) Oh no!
He pauses and looks something up on his computer.
(Swimmy) Apparently you can get them back, you just need to find 3 magic crystals! Maybe you can find them. Look around!

>s
Hallway Outside Room 202
You are in a hallway. To your north is a door labeled "Swimmy's Room", Room 202, and to your west there is a hallway.

* * *

>e
Hallway Outside Room 101
You are in a hallway. To your north is a door labeled "Little Giraffe's Room", Room 101, and to your east and west there is more hallway.

>purloin floatie
[Purloined.]

>n
(first opening Little Giraffe's door)

Little Giraffe's Room
You are in a bedroom with grassy wallpaper, a bed, a couch, a desk, and a bunch of books on top of a shelf.

Little Giraffe is sitting on the couch watching TV.

>talk
(to Little Giraffe)
(Little Giraffe) What is it, Dave? Did you bring me candy?
(You) No, but I lost my powers this morning...
(Little Giraffe) Maybe I have something that will help. If you find my pool floatie I will give you one of my special toys!
(You) Ok, I will find it!.

 Little Giraffe cheers at something on the TV.

>give floatie
(to Little Giraffe)
(Little Giraffe) Thanks! Where was it?
(You) It was at the pool, obviously.
(Little Giraffe) Oh. Well, you can have this pogo stick!

>i
You are carrying:
  Pogo Stick

>look at pogo
A stick with a handle, two footholds, and it is very bouncy.

 A loud explosion comes from the TV.

* * *

>e
Hallway Outside Room 100
You are in a hallway. To your north is a door labeled "Bear Bear's Room", Room 100, and to your east there is a hallway, and to your west there is an elevator.

>n
(first opening BearBear's door)

BearBear's Room
You are in a bedroom with honey wallpaper, a bed, a couch, a TV, and a bunch of books on top of a shelf.

Bear Bear is sitting on the couch watching basketball.

>talk
(to BearBear)
(Bear Bear) What is it, Dave?
(You) Oh, I lost my powers this morning...
(Bear Bear) Hmmm... I have something that might help you, but could you find me a honey cake from the kitchen first?
(You) Ok, I will bring one back here.

Bear Bear yells at the TV.

>d
You can't go that way.

>d
You can't go that way.

>d
You can't go that way.

Bear Bear yells at the TV.

>s
Hallway Outside Room 100
You are in a hallway. To your north is a door labeled "Bear Bear's Room", Room 100, and to your east there is a hallway, and to your west there is an elevator.

* * *

>e
Hallway Outside Room 101
You are in a hallway. To your north is a door labeled "Little Giraffe's Room", Room 101, and to your east and west there is more hallway.

>n
(first opening Little Giraffe's door)

Little Giraffe's Room
You are in a bedroom with grassy wallpaper, a bed, a couch, a desk, and a bunch of books on top of a shelf.

Little Giraffe is sitting on the couch watching TV.

 Little Giraffe cheers at something on the TV.

>talk to
(Little Giraffe)
(Little Giraffe) What is it, Dave? Did you bring me candy?
(You) No, but I lost my powers this morning...
(Little Giraffe) Maybe I have something that will help. If you find my pool floatie I will give you one of my special toys!
(You) Ok, I will find it!.

 A loud explosion comes from the TV.

>s
Hallway Outside Room 101
You are in a hallway. To your north is a door labeled "Little Giraffe's Room", Room 101, and to your east and west there is more hallway.

>e
Hallway Outside Room 102
You are in a hallway. To your north is a door labeled "Big Giraffe's Room", Room 102, and to your west there a hallway.

>n
(first opening Big Giraffe's door)

Big Giraffe's Room
You are in a bedroom with grassy wallpaper, a bed, a couch, a desk, and  photos on the wall.

Big Giraffe is sewing something.

>talk to
(Big Giraffe)
(Big Giraffe) Hi Dave.
(You) I lost my powers this morning!
(Big Giraffe) Oh no! It looks like you have already talked to Little Giraffe, but I don't have much I can do.
(You) Bye Big Giraffe!

* * *

>e
Hallway Outside Room 101
You are in a hallway. To your north is a door labeled "Little Giraffe's Room", Room 101, and to your east and west there is more hallway.

>s
You can't go that way.

>w
Hallway Outside Room 100
You are in a hallway. To your north is a door labeled "Bear Bear's Room", Room 100, and to your east there is a hallway, and to your west there is an elevator.

* * *

>s
South Plains of Car Pet
You are in a desolate wasteland, and the ground is striped with red and white. To your north the plains continue, to your east is the Hills of Kauch and to your south is the enourmous Bukshelv Cliff.

>e
Hills of Kauch
You are on some navy blue hills, and to your east is a view that seems to go on forever.

>w
South Plains of Car Pet
You are in a desolate wasteland, and the ground is striped with red and white. To your north the plains continue, to your east is the Hills of Kauch and to your south is the enourmous Bukshelv Cliff.

>purloin pogo
[Purloined.]

>s
Lower Central Bukshelv Cliff
You are at the base of the most enormous cliff imaginable. It is so steep, how on earth can you get up there? The base of the cliff stretches on to your east and west, to your south is the Plains of Car Pet.

>e
Lower East Bukshelv Cliff
You are at the base of the most enormous cliff imaginable. It is so steep, how on earth can you get up there? The base of the cliff stretches on to your west.

>up
BOING! you bounce up the Cliff with your pogo stick.

Upper East Bukshelv Cliff
You are at the top of the world, it feels like. To your west the top of the cliff continues, and below you is the lower slopes of the cliff.

>w
You can't go that way.

>e
You can't go that way.

>down
Lower East Bukshelv Cliff
You are at the base of the most enormous cliff imaginable. It is so steep, how on earth can you get up there? The base of the cliff stretches on to your west.

>w
Lower Central Bukshelv Cliff
You are at the base of the most enormous cliff imaginable. It is so steep, how on earth can you get up there? The base of the cliff stretches on to your east and west, to your south is the Plains of Car Pet.

>up
BOING! you bounce up the Cliff with your pogo stick.

Bukshelv Cliff Summit
You are at the top of the world, it feels like. To your east and west the top of the cliff continues, and below you is the lower slopes of the cliff. You can see a large chunk of rock on the ground.

Godzilla is standing at the top, enjoying the view.

>talk to godzilla
(Godzilla) Why do you need magic powers if you have a view like this?

>break rock
You hack open the rock, revealing a blue glowing chunk of crystal.

>take crystal
Taken.

>i
You are carrying:
  Blue Magic Crystal
  Pogo Stick

* * *

>up
You try climbing but you slide back down after a few feet.

>purloin pogo
[Purloined.]

>up
BOING! you bounce up the Cliff with your pogo stick.

Bukshelv Cliff Summit
You are at the top of the world, it feels like. To your east and west the top of the cliff continues, and below you is the lower slopes of the cliff. You can see a large chunk of rock on the ground.

>break chunk of rock
You hack open the rock, revealing a blue glowing chunk of crystal.

>look
Bukshelv Cliff Summit
You are at the top of the world, it feels like. To your east and west the top of the cliff continues, and below you is the lower slopes of the cliff. You can see a large blue Magic Crystal on the ground.

>open chunk of rock
You can't see any such thing.

>take crystal
Taken.

* * *

>i
You are carrying:
  Blue Magic Crystal
  Pogo Stick

>purloin pink crystal
[Purloined.]

>i
You are carrying:
  Pink Magic Crystal
  Blue Magic Crystal
  Pogo Stick

* * *

>s
Lower Central Bukshelv Cliff
You are at the base of the most enormous cliff imaginable. It is so steep, how on earth can you get up there? The base of the cliff stretches on to your east and west, to your south is the Plains of Car Pet.

>w
Lower West Bukshelv Cliff
You are at the base of the most enormous cliff imaginable. It is so steep, how on earth can you get up there? The base of the cliff stretches on to your east.

You see a giant bull who seems to enjoy sitting at the base of this majestic cliff.

* * *

>talk to bull
(Benny the Bull) I heard that there's a magic crystal up there, but it's too steep for me.

>talk to benny
(Benny) I heard that there's a magic crystal up there, but it's too steep for me.

>ask benny for crystal
You can't see any such thing.

* * *

>talk to bull
(Benny the Bull) I heard that there's a magic crystal up there, but it's too steep for me.

>up
You try climbing but you slide back down after a few feet. Hmm... you might need something bouncy?

>purloin pogo stick
[Purloined.]

>up
BOING! you bounce up the Cliff with your pogo stick.

Upper West Bukshelv Cliff
You are at the top of the world, it feels like. To your east the top of the cliff continues, and below you is the lower slopes of the cliff.

>e
Bukshelv Cliff Summit
You are at the top of the world, it feels like. To your east and west the top of the cliff continues, and below you is the lower slopes of the cliff. You can see a large chunk of rock on the ground.

Godzilla is standing at the top, enjoying the view.

>talk to godzilla
(Godzilla) Why do you need magic powers if you have a view like this?

* * *

>down
Elevator Floor 1
You are in an elevator room. The elevator can go up but not down. To your east is a hallway, and to your south is a door labeled "Commons".

>w
You can't go that way.

>e
Hallway Outside Room 100
You are in a hallway. To your north is a door labeled "Bear Bear's Room", Room 100, and to your east there is a hallway, and to your west there is an elevator.

* * *

>n
(first opening BearBear's door)

BearBear's Room
You are in a bedroom with honey wallpaper, a bed, a couch, a TV, and a bunch of books on top of a shelf.

Bear Bear is sitting on the couch watching basketball.

>talk to bear
(Bear Bear) What is it, Dave?
(You) Oh, I lost my powers this morning...
(Bear Bear) Hmmm... I have something that might help you, but could you find me a honey cake from the kitchen first?
(You) Ok, I will bring one back here.

>s
Hallway Outside Room 100
You are in a hallway. To your north is a door labeled "Bear Bear's Room", Room 100, and to your east there is a hallway, and to your west there is an elevator.

* * *

>e
Hallway Outside Room 101
You are in a hallway. To your north is a door labeled "Little Giraffe's Room", Room 101, and to your east and west there is more hallway.

>n
(first opening Little Giraffe's door)

Little Giraffe's Room
You are in a bedroom with grassy wallpaper, a bed, a couch, a desk, and a bunch of books on top of a shelf.

Little Giraffe is sitting on the couch watching TV.

>talk to little giraffe
(Little Giraffe) What is it, Dave? Did you bring me candy?
(You) No, but I lost my powers this morning...
(Little Giraffe) Maybe I have something that will help. If you find my pool floatie I will give you one of my special toys!
(You) Ok, I will find it!.

 Little Giraffe cheers at something on the TV.

>s
Hallway Outside Room 101
You are in a hallway. To your north is a door labeled "Little Giraffe's Room", Room 101, and to your east and west there is more hallway.

* * *

>n
(first opening Big Giraffe's door)

Big Giraffe's Room
You are in a bedroom with grassy wallpaper, a bed, a couch, a desk, and  photos on the wall.

Big Giraffe is sewing something.

>talk to big giraffe
(Big Giraffe) Hi Dave.
(You) I lost my powers this morning!
(Big Giraffe) Oh no! Sorry, but there is not much I can do. Try talking to Little Giraffe.
(You) I already did!
(Big Giraffe) Oh, then maybe she has something for you. Good luck Dave!

>s
Hallway Outside Room 102
You are in a hallway. To your north is a door labeled "Big Giraffe's Room", Room 102, and to your west there a hallway.

>e
You can't go that way.

* * *

>w
Hallway Outside Room 100
You are in a hallway. To your north is a door labeled "Bear Bear's Room", Room 100, and to your east there is a hallway, and to your west there is an elevator.

>ww
That's not a verb I recognise.

>w
Elevator Floor 1
You are in an elevator room. The elevator can go up but not down. To your east is a hallway, and to your west is a door labeled "Commons".

>up
Elevator Floor 2
You are in an elevator room. The elevator can go up or down. To your east is a hallway.

* * *

>e
Hallway Outside Room 300
You are in a hallway. To your north is a door labeled "Tiggery's Room", Room 300, and to your east there is a hallway, to your west is an elevator, and to your south is the dining room.

>north
(first opening Tiggery's door)

Tiggery's Room
You are in a bedroom with orange striped wallpaper, a bed, a couch, a desk, and tools hanging on the wall.

Tiggery is making something with his tools.

* * *

>talk to tiggery
(Tiggery) What's going on, Dave?
(You) I lost my powers this morning!
(Tiggery) That's not good! Swimmy probably already told you, but you need apparently 4 magic crystals.
(You) I know!
(Tiggery) Anyway, I don't have anything to help you with, sorry. If you could bring me some sushi that would be good though!

>s
Hallway Outside Room 300
You are in a hallway. To your north is a door labeled "Tiggery's Room", Room 300, and to your east there is a hallway, to your west is an elevator, and to your south is the dining room.

* * *

>e
Hallway Outside Room 301
You are in a hallway. To your north is a door labeled "Orca's Room", Room 301, and to your west there is a hallway.

>north
(first opening Orca's door)
It seems to be locked.

>w
Hallway Outside Room 300
You are in a hallway. To your north is a door labeled "Tiggery's Room", Room 300, and to your east there is a hallway, to your west is an elevator, and to your south is the dining room.

>down
You can't go that way.

>south
Dining Room
You are in a large area with a bunch of round tables. To your north is a hallway, and to your west is a door to the pool.

Orca is sitting at one of the tables.

Fladibearius is sitting at another table.

>talk to fladdy
You can't see any such thing.

>talk to fladibearius
(Fladibearius) Hi Dave, I heard about what happened. I can't really help you.
(You) That's fine Fladibearius. What are you eating?
(Fladibearius) This is honey cake. Do you want any?
(Yes or No)

>yes
(Fladibearius) Here you are!

>talk to fladibearius
(Fladibearius) I hope you get your powers back Dave!

>talk to Orca
(Orca) Swimmy told me what happened, Dave.
(You) Can you help me?
(Orca) What do you need?
(You) Do you have any sushi?
(Orca) Oh! Yes, here you go. Bye Dave!

>n
Hallway Outside Room 300
You are in a hallway. To your north is a door labeled "Tiggery's Room", Room 300, and to your east there is a hallway, to your west is an elevator, and to your south is the dining room.

>north
Tiggery's Room
You are in a bedroom with orange striped wallpaper, a bed, a couch, a desk, and tools hanging on the wall.

Tiggery is making something with his tools.

* * *

>talk to tiggery
(Tiggery) Sushi is the best! You can probably find some in the Dining Room.

>give sushi
(to Tiggery)
(Tiggery) Oh wow! Thank you!
(Tiggery) I just realized, I can give you this Key. I don't know why you would want it, but here you go!

>s
Hallway Outside Room 300
You are in a hallway. To your north is a door labeled "Tiggery's Room", Room 300, and to your east there is a hallway, to your west is an elevator, and to your south is the dining room.

* * *

>w
Elevator Floor 3
You are in an elevator room. The elevator can go down but not up. To your south is a door labeled "Pool", and to your east is a door labeled "Dining Room and Rooms".

>look at key
A key that is labeled "Sylvia's key".

>s
You can't go that way.

>sown
That's not a verb I recognise.

>down
Elevator Floor 2
You are in an elevator room. The elevator can go up or down. To your east is a hallway.

>e
Hallway Outside Room 200
You are in a hallway. To your north is a door labeled "Sylvia's room", Room 200, and to your east there is a hallway, and to your west there is an elevator.

* * *

>w
Elevator Floor 2
You are in an elevator room. The elevator can go up or down. To your east is a hallway.

>n
You can't go that way.

>up
Elevator Floor 3
You are in an elevator room. The elevator can go down but not up. To your west is a door labeled "Kitchen", and to your east is a door labeled "Dining Room".

* * *

>n
(first opening Tiggery's door)

Tiggery's Room
You are in a bedroom with orange striped wallpaper, a bed, a couch, a desk, and tools hanging on the wall.

Tiggery is making something with his tools.

>talk
(to Tiggery)
(Tiggery) What's going on, Dave?
(You) I lost my powers this morning!
(Tiggery) That's not good! Swimmy probably already told you, but you need apparently 4 magic crystals.
(You) I know!
(Tiggery) Anyway, I don't have anything to help you with, sorry. If you could bring me some sushi that would be good though!

>s
Hallway Outside Room 300
You are in a hallway. To your north is a door labeled "Tiggery's Room", Room 300, and to your east there is a hallway, to your west is an elevator, and to your south is the dining room.

* * *

>s
Dining Room
You are in a large area with a bunch of round tables. To your north is a hallway, and to your west is a door to the pool.

Orca is sitting at one of the tables.

Fladibearius is sitting at another table.

>talk to orca
(Orca) Swimmy told me what happened, Dave.
(You) Can you help me?
(Orca) What do you need?
(You) Do you have any sushi?
(Orca) Oh! Yes, here you go. Bye Dave!

>talk to flad
You can't see any such thing.

>talk to fladibearius
(Fladibearius) Hi Dave, I heard about what happened. I can't really help you.
(You) That's fine Fladibearius. What are you eating?
(Fladibearius) This is honey cake. Do you want any?
(Yes or No)

* * *

>yes
(Fladibearius) Here you are!

>n
Hallway Outside Room 300
You are in a hallway. To your north is a door labeled "Tiggery's Room", Room 300, and to your east there is a hallway, to your west is an elevator, and to your south is the dining room.

* * *

>give sushi
(to Tiggery)
(Tiggery) Oh wow! Thank you!
(Tiggery) I just realized, I can give you this Key. I don't know why you would want it, but here you go!

>i
You are carrying:
  Small Key
  Honey Cake

>look at key
A key that is labeled "Sylvia's key".

>s
Hallway Outside Room 300
You are in a hallway. To your north is a door labeled "Tiggery's Room", Room 300, and to your east there is a hallway, to your west is an elevator, and to your south is the dining room.

>w
Elevator Floor 3
You are in an elevator room. The elevator can go down but not up. To your west is a door labeled "Pool", and to your east is a door labeled "Dining Room and Rooms".

>down
Elevator Floor 2
You are in an elevator room. The elevator can go up or down. To your east is a hallway.

* * *

>n
(first opening Sylvia's door)
It seems to be locked.

>use key
That's not a verb I recognise.

>unlock door
What do you want to unlock Sylvia's door with?

>small key
You unlock Sylvia's door.

>lock door
What do you want to lock Sylvia's door with?

>key
You lock Sylvia's door.

>unlock sylvia's door
What do you want to unlock Sylvia's door with?

>key
You unlock Sylvia's door.

* * *

>n
(first opening Sylvia's door)

Sylvia's Room
You are in a pink bedroom with a bed and a closet, and an oven that smells like chocolate cake. To your south is the exit.

Sylvia is snoring loudly on the bed.

>look at sylvia
Upon closer examination, Sylvia seems to be dreaming about chocolate cake.

* * *

>talk to orca
(Orca) Swimmy told me what happened, Dave.
(You) Can you help me?
(Orca) What do you need?
(You) Do you have any sushi?
(Orca) Oh! Yes, here you go. Bye Dave!

>talk to fladibearius
(Fladibearius) Hi Dave, I heard about what happened. I can't really help you, sorry!
(You) That's fine Fladibearius. What are you eating?
(Fladibearius) This is honey cake. Do you want any?
(Yes or No)

* * *

>n
Tiggery's Room
You are in a bedroom with orange striped wallpaper, a bed, a couch, a desk, and tools hanging on the wall.

Tiggery is making something with his tools.

>give honey cake
(to Tiggery)
Tiggery doesn't seem interested.

>give sushi
(to Tiggery)
(Tiggery) Oh wow! Thank you!
(Tiggery) I just realized, I can give you this Key. I don't know why you would want it, but here you go!

* * *

>s
Outdoor Balcony
A large balcony. To the east is the Dining Room, and to the North is the Elevator.

You can see a Pool here.

>look at pool
The sun reflects off the water, and you can see something floating on the water. It appears to be a giraffe floatie.

* * *

>take floatie
Taken.

>n
Elevator Floor 3
You are in an elevator room. The elevator can go down but not up. To your south is a door labeled "Pool", and to your east is a door labeled "Dining Room and Rooms".

>down
Elevator Floor 2
You are in an elevator room. The elevator can go up or down. To your east is a hallway.

* * *

>e
Hallway Outside Room 100
You are in a hallway. To your north is a door labeled "Bear Bear's Room", Room 100, and to your east there is a hallway, and to your west there is an elevator.

>n
(first opening BearBear's door)

BearBear's room
You are in a bedroom with honey wallpaper, a bed, a couch, a TV, and a bunch of books on top of a shelf.

Bear Bear is sitting on the couch watching basketball.

Bear Bear yells at the TV.

>talk to bear
(Bear Bear) What is it, Dave?
(You) Oh, I lost my powers this morning...
(Bear Bear) Hmmm... I have something that might help you, but could you find me a honey cake from the kitchen first?
(You) Ok, I will bring one back here.

>give honey cake
(to BearBear)
(Bear Bear) Oh wow! Thank you!
(Bear Bear) Thanks! Hmm, what can I give you? Oh! I have some M&Ms. Here you go!

>s
Hallway Outside Room 100
You are in a hallway. To your north is a door labeled "Bear Bear's Room", Room 100, and to your east there is a hallway, and to your west there is an elevator.

* * *

>e
Hallway Outside Room 101
You are in a hallway. To your north is a door labeled "Little Giraffe's Room", Room 101, and to your east and west there is more hallway.

>n
(first opening Little Giraffe's door)

Little Giraffe's room
You are in a bedroom with grassy wallpaper, a bed, a couch, a desk, and a bunch of books on top of a shelf.

Little Giraffe is sitting on the couch watching TV.

>talk
(to Little Giraffe)
(Little Giraffe) What is it, Dave? Did you bring me candy?
(You) No, but I lost my powers this morning...
(Little Giraffe) Maybe I have something that will help. If you find my pool floatie I will give you one of my special toys!
(You) Ok, I will find it!.

 Little Giraffe cheers at something on the TV.

* * *

>give floatie
(to Little Giraffe)
(Little Giraffe) Thanks! Where was it?
(You) It was at the pool, obviously.
(Little Giraffe) Oh. Well, you can have this pogo stick!

>s
Hallway Outside Room 101
You are in a hallway. To your north is a door labeled "Little Giraffe's Room", Room 101, and to your east and west there is more hallway.

* * *

>up
Elevator Floor 2
You are in an elevator room. The elevator can go up or down. To your east is a hallway.

>e
Hallway Outside Room 200
You are in a hallway. To your north is a door labeled "Sylvia's room", Room 200, and to your east there is a hallway, and to your west there is an elevator.

* * *

>n
(first opening Sylvia's door)

Sylvia's Room
You are in a pink bedroom with a bed and a closet, and an oven that smells like chocolate cake. To your south is the exit.

Sylvia is snoring loudly on the bed.

>talk to sylvia
She is fast asleep, dreaming about fancy chocolate and dancing.

>wake sylvia
Sylvia wakes up.
(Sylvia) What is going on???
(You) I lost all of my powers! Do you have a magic crystal?
(Sylvia) Yes, but I will give you one only if you bring me chocolate.

>z
Time passes.

Sylvia fell asleep again.

>give chocolate
(to Sylvia)
(Sylvia) Hmmmmmm? Oh, CHOCOLATE!!!!!!
(Sylvia) Ok, I guess I should give you your magic crystal now.

>s
Hallway Outside Room 200
You are in a hallway. To your north is a door labeled "Sylvia's room", Room 200, and to your east there is a hallway, and to your west there is an elevator.

>w
Elevator Floor 2
You are in an elevator room. The elevator can go up or down. To your east is a hallway.

* * *

>s
Lower Central Bukshelv Cliff
You are at the base of the most enormous cliff imaginable. It is so steep, how on earth can you get up there? The base of the cliff stretches on to your east and west, to your south is the Plains of Car Pet.

>up
BOING! you bounce up the Cliff with your pogo stick.

Bukshelv Cliff Summit
You are at the top of the world, it feels like. To your east and west the top of the cliff continues, and below you is the lower slopes of the cliff. You can see a large chunk of rock on the ground.

>break chunk
You hack open the rock, revealing a blue glowing chunk of crystal.

>take crystal
(Pink Magic Crystal)
You already have that.

>take blue
Taken.

>i
You are carrying:
  Blue Magic Crystal
  Pink Magic Crystal
  Pogo Stick
  Small Key

* * *

>use key
That's not a verb I recognise.

>open door
It seems to be locked.

>unlock door
What do you want to unlock Sylvia's door with?

>key
That doesn't seem to fit the lock.

>unlock door
What do you want to unlock Sylvia's door with?

>small key
That doesn't seem to fit the lock.

>i
You are carrying:
  Small Key
  Honey Cake

* * *

>look at key
A key that is labeled "Sylvia's key".

>unlock door
What do you want to unlock Sylvia's door with?

* * *

>up
Elevator Floor 3
You are in an elevator room. The elevator can go down but not up. To your south is a door labeled "Pool", and to your east is a door labeled "Dining Room and Rooms".

>s
Outdoor Balcony
A large balcony. To the east is the Dining Room, and to the North is the Elevator.

You can see a Pool and Bucket here.

>e
Dining Room
You are in a large area with a bunch of round tables. To your north is a hallway, and to your west is a door to the pool.

On the Fruit Dispenser is a fruit selection. They are all mangoes, the best fruit ever.

Orca is sitting at one of the tables.

Fladibearius is sitting at another table.

>take drink
(the drink dispenser)
That's fixed in place.

>take soda
Taken.

>drink soda
It tastes delicious.

There's nothing suitable to drink here.

>i
You are carrying:
  a soda

* * *

>e
Dining Room
You are in a large area with a bunch of round tables. To your north is a hallway, and to your west is a door to the pool.

On the Fruit Dispenser is a fruit selection. They are all mangoes, the best fruit ever.

Orca is sitting at one of the tables.

Fladibearius is sitting at another table.

>take mango
You can't see any such thing.

>take fruit
(the Fruit Dispenser)
That's fixed in place.

>take fruit selection
All out.
Taken.

* * *

>e
Dining Room
You are in a large area with a bunch of round tables. To your north is a hallway, and to your west is a door to the pool.

On the Fruit Dispenser is a fruit selection. They are all mangoes, the best fruit ever.

Orca is sitting at one of the tables.

Fladibearius is sitting at another table.

>take soda
Taken.

>i
You are carrying:
  a soda

>take soda
You already have that.

>take another soda
You already have that.

>i
You are carrying:
  a soda

>drink soda
It tastes delicious.

You eat the soda. Not bad.

* * *

>south
Outdoor Pool
A large outdoor pool. To the east is the Dining Room, and to the North is the Elevator.

>east
Dining Room
You are in a large area with a bunch of round tables. To your north is a hallway, and to your west is a door to the pool.

Orca is sitting at one of the tables.

Fladibearius is sitting at another table.

* * *

>talk
(to Swimmy)
(Swimmy) Hi Dave, what is it?
(You) I lost my magic powers this morning.
(Swimmy) Oh no!
He pauses and looks something up on his computer.
(Swimmy) Apparently you can get them back, you just need to find 3 magic crystals! Maybe you can find them. Look around! And if you find them, make sure to bring them back to me.

>talk
(to Swimmy)
(Swimmy) Good luck Dave!

>purloin blue
[Purloined.]

* * *

>purloin pink
[Purloined.]

>purloin green crystal
[Purloined.]

>i
You are carrying:
  Green Magic Crystal
  Pink Magic Crystal
  Blue Magic Crystal

>talk to swimmy
(Swimmy) Good luck Dave!

* * *

>talk
(to Swimmy)
(Swimmy) Hi Dave, what is it?
(You) I lost my magic powers this morning.
(Swimmy) Oh no!
He pauses and looks something up on his computer.
(Swimmy) Apparently you can get them back, you just need to find 3 magic crystals! Maybe you can find them. Look around! And if you find them, make sure to bring them back to me.

>w
You can't go that way.

* * *

>s
Lower Central Bukshelv Cliff
You are at the base of the most enormous cliff imaginable. It is so steep, how on earth can you get up there? The base of the cliff stretches on to your east and west, to your south is the Plains of Car Pet.

>purloin pogo stick
[Purloined.]

>up
BOING! you bounce up the Cliff with your pogo stick.

Bukshelv Cliff Summit
You are at the top of the world, it feels like. To your east and west the top of the cliff continues, and below you is the lower slopes of the cliff. You can see a large chunk of rock.

>look at chunk of rock
A large chunk of rock. Maybe something is inside?

>open chunk of rock
It won't open on it's own, maybe you need to break it open?

>break rock
You hack open the rock, revealing a blue glowing chunk of crystal.

>i
You are carrying:
  Pogo Stick

>take crystal
You can't see any such thing.

>take blue crystal
You can't see any such thing.

* * *

>n
(first opening Swimmy's door)

Swimmy's room
You are in a bedroom with ocean wallpaper, a bed, a couch, and a bunch of tools on top of a desk.

Swimmy is sitting on the couch reading a book.

>talk to swimmy
(Swimmy) Hi Dave, what is it?
(You) I lost my magic powers this morning.
(Swimmy) Oh no!
He pauses and looks something up on his computer.
(Swimmy) Apparently you can get them back, you just need to find 4 magic crystals! Maybe you can find them. Look around!

* * *

>e
Hallway Outside Room 101
You are in a hallway. To your north is a door labeled "Little Giraffe's Room", Room 101, and to your east and west there is more hallway.

>e
Hallway Outside Room 102
You are in a hallway. To your north is a door labeled "Big Giraffe's Room", Room 102, and to your west there a hallway.

* * *

>n
(first opening Big Giraffe's door)

Big Giraffe's Room
You are in a bedroom with grassy wallpaper, a bed, a couch, a desk, and  photos on the wall.

Big Giraffe is sewing something.

>talk to big giraffe
(Big Giraffe) Sorry, but I am a little bit busy. Maybe you can go talk to Little Giraffe? She is in the next room over.

* * *

>down
Elevator Floor 1
You are in an elevator room. The elevator can go up but not down. To your east is a hallway, and to your west is a door labeled "Commons".

>e
Hallway Outside Room 100
You are in a hallway. To your north is a door labeled "Bear Bear's Room", Room 100, and to your west there is a hallway, and to your east there is an elevator.

>n
BearBear's Room
You are in a bedroom with honey wallpaper, a bed, a couch, a TV, and a bunch of books on top of a shelf.

Bear Bear is sitting on the couch watching TV.

>talk to bear bear
(Bear Bear) What is it, Dave?
(You) Oh, I lost my powers this morning...
(Bear Bear) Hmmm... I have something that might help you, but could you find me a honey cake from the kitchen first?
(You) Ok, I will bring one back here.

>talk to bear bear
(Bear Bear) I want some cake!

>s
Hallway Outside Room 100
You are in a hallway. To your north is a door labeled "Bear Bear's Room", Room 100, and to your west there is a hallway, and to your east there is an elevator.

>w
Elevator Floor 1
You are in an elevator room. The elevator can go up but not down. To your east is a hallway, and to your west is a door labeled "Commons".

>e
Hallway Outside Room 100
You are in a hallway. To your north is a door labeled "Bear Bear's Room", Room 100, and to your west there is a hallway, and to your east there is an elevator.

I beg your pardon?

>e
Hallway Outside Room 101
You are in a hallway. To your north is a door labeled "Little Giraffe's Room", Room 101, and to your east and west there is more hallway.

>n
Little Giraffe's Room
You are in a bedroom with grassy wallpaper, a bed, a couch, a desk, and a bunch of books on top of a shelf.

Little Giraffe is sitting on the couch watching TV.

>talk to little giraffe
(Little Giraffe) What is it, Dave? Did you bring me candy?
(You) No, but I lost my powers this morning...
(Little Giraffe) Maybe I have something that will help. If you find my pool floatie I will give you one of my special toys!
(You) Ok, I will find it!.

* * *

>w
Hallway Outside Dave's Room
You are in a hallway. To your north is a door labeled "Dave's room", Room 201, and to your east and west the hallway continues.

I beg your pardon?

>ww
That's not a verb I recognise.

>w
Hallway Outside Room 200
You are in a hallway. To your north is a door labeled "Sylvia's room", Room 200, and to your east there is a hallway, and to your west there is an elevator.

* * *

>talk to little giraffe
(Little Giraffe) What is it, Dave? Did you bring me candy?
(You) No, but I lost my powers this morning...
(Little Giraffe) Maybe I have something that will help. If you find my pool floatie I will give you one of my special toys!
(You) Ok, I will find it!.

>d
You can't go that way.

 A loud explosion comes from the TV.

I beg your pardon?

>d
You can't go that way.

>d
You can't go that way.

 Little Giraffe cheers at something on the TV.

>d
You can't go that way.

 A loud explosion comes from the TV.

>d
You can't go that way.

>look
Little Giraffe's Room
You are in a bedroom with grassy wallpaper, a bed, a couch, a desk, and a bunch of books on top of a shelf.

Little Giraffe is sitting on the couch watching TV.

>look at couch
You can't see any such thing.

>look at bed
You can't see any such thing.

>look at wallpaper
You can't see any such thing.

>look at books
You can't see any such thing.

>d
You can't go that way.

>w
You can't go that way.

 Little Giraffe cheers at something on the TV.

>s
Hallway Outside Room 101
You are in a hallway. To your north is a door labeled "Little Giraffe's Room", Room 101, and to your east and west there is more hallway.

* * *

>talk to swimmy
(Swimmy) Good luck Dave!

>look
Swimmy's Room
You are in a bedroom with ocean wallpaper, a bed, a couch, and a bunch of tools on top of a desk.

Swimmy is sitting on the couch reading a book.

>s
Hallway Outside Room 202
You are in a hallway. To your north is a door labeled "Swimmy's Room", Room 202, and to your west there is a hallway.

* * *

>w
Hallway Outside Room 200
You are in a hallway. To your north is a door labeled "Sylvia's room", Room 200, and to your east there is a hallway, and to your west there is an elevator.

>n
Sylvia's Room
You are in a pink bedroom with a bed and a closet, and an oven that smells like chocolate cake. To your south is the exit.

Sylvia is snoring loudly on the bed.

>look at sylvia
Upon closer examination, Sylvia seems to be dreaming about chocolate cake.

>talk to sylvia
She is fast asleep, dreaming about fancy chocolate and dancing.

>s
Hallway Outside Room 200
You are in a hallway. To your north is a door labeled "Sylvia's room", Room 200, and to your east there is a hallway, and to your west there is an elevator.

* * *

>w
Elevator Floor 2
You are in an elevator room. The elevator can go up or down. To your east is a hallway.

>up
Elevator Floor 3
You are in an elevator room. The elevator can go down but not up. To your west is a door labeled "Kitchen", and to your east is a door labeled "Dining Room".

>d
Elevator Floor 2
You are in an elevator room. The elevator can go up or down. To your east is a hallway.

>down
Elevator Floor 1
You are in an elevator room. The elevator can go up but not down. To your east is a hallway, and to your west is a door labeled "Commons".

* * *

>e
Hallway Outside Room 100
You are in a hallway. To your north is a door labeled "Bear Bear's Room", Room 100, and to your west there is a hallway, and to your east there is an elevator.

>n
'Bear Bear's Room'
You are in a bedroom with honey wallpaper, a bed, a couch, a TV, and a bunch of books on top of a shelf.

You can see 'Bear Bear' here.

>talk to Bear Bear
You can't see any such thing.

>talk to 'Bear Bear'
You can only do that to something animate.

* * *

>e
Hallway Outside Room 202
You are in a hallway. To your north is a door labeled "Swimmy's Room", Room 202, and to your west there is a hallway.

>w
Hallway Outside Dave's Room
You are in a hallway. To your north is a door labeled "Dave's room", Room 201, and to your east and west the hallway continues.

>e
Hallway Outside Room 202
You are in a hallway. To your north is a door labeled "Swimmy's Room", Room 202, and to your west there is a hallway.

* * *

>up
Elevator Floor 3
You are in an elevator room. The elevator can go down but not up. To your west is a door labeled "Pool", and to your east is a door labeled "Dining Room and Rooms".

>east
Hallway Outside Room 300
You are in a hallway. To your north is a door labeled "Tiggery's Room", Room 300, and to your east there is a hallway, to your west is an elevator, and to your south is the dining room.

>s
Dining Room
You are in a large area with a bunch of round tables.

Orca is sitting at one of the tables.

>talk to orca
(Orca) Swimmy told me what happened, Dave.
(You) Can you help me?
(Orca) What do you need?
(You) Um, nothing.
(Orca) Well, have some sushi!
You eat sushi with Orca.
(Orca) Bye Dave!

>n
Hallway Outside Room 300
You are in a hallway. To your north is a door labeled "Tiggery's Room", Room 300, and to your east there is a hallway, to your west is an elevator, and to your south is the dining room.

* * *

>s
Hallway Outside Room 300
You are in a hallway. To your north is a door labeled "Tiggery's Room", Room 300, and to your east there is a hallway, to your west is an elevator, and to your south is the dining room.

>s
Dining Room
You are in a large area with a bunch of round tables.

Orca is sitting at one of the tables.

>talk to orca
(Orca) Hi again! Do you need anything?
(You) Could I have some sushi to take to Tiggery?
(Orca) Sure! Here you go! Bye!

>n
Hallway Outside Room 300
You are in a hallway. To your north is a door labeled "Tiggery's Room", Room 300, and to your east there is a hallway, to your west is an elevator, and to your south is the dining room.

* * *

>n
Tiggery's Room
You are in a bedroom with orange striped wallpaper, a bed, a couch, a desk, and tools hanging on the wall.

Tiggery is making something with his tools.

>give sushi
(to Tiggery)
(Tiggery) Oh wow! Thank you!
(Tiggery) I just realized, I can give you this CD. I don't know why you would want it, but here you go!

>i
You are carrying:
  CD

* * *

>w
Hallway Outside Room 200
You are in a hallway. To your north is a door labeled "Sylvia's room", Room 200, and to your east there is a hallway, and to your west there is an elevator.

>n
(first opening The oak door)
It seems to be locked.

* * *

>s
(first opening Dave's door)

Hallway Outside Dave's Room
You are in a hallway. To your north is a door labeled "Dave's room", Room 201, and to your east and west the hallway continues.

>lock dave's door
(with Dave's door)
(first taking Dave's door)
That's hardly portable.

>take dave's door
That's hardly portable.

>lock door
(with Dave's door)
(first taking Dave's door)
That's hardly portable.

>o
Sorry, that can't be corrected.

>u
Hmm... maybe I should go talk to some people before I leave.

>undo
Hallway Outside Dave's Room
[Previous turn undone.]

>undo
Hallway Outside Dave's Room
[Previous turn undone.]

>undo
Dave's Bedroom
[Previous turn undone.]

>undo
You can't "undo" what hasn't been done!

* * *

>s
(first opening Dave's door)

Hallway Outside Dave's Room
You are in a hallway. To your north is a door labeled "Dave's room", Room 201, and to your east and west the hallway continues.

>scene
That's not a verb I recognise.

>scenes
Scene 'Entire Game' playing (for 1 mins now)
Scene 'Getting Acquainted' playing (for 1 mins now)
(Scene monitoring now switched on. Type "scenes off" to switch it off again.)

>s
You can't go that way.

>s
You can't go that way.

>w
Hallway Outside Room 200
You are in a hallway. To your north is a door labeled "Sylvia's room", Room 200, and to your east there is a hallway, and to your west there is an elevator.

>e
Hallway Outside Dave's Room
You are in a hallway. To your north is a door labeled "Dave's room", Room 201, and to your east and west the hallway continues.

* * *

>n
(first opening Swimmy's door)

Swimmy's Room
You are in a bedroom with ocean wallpaper, a bed, a couch, and a bunch of tools on top of a desk.

Swimmy is sitting on the couch reading a book.

>talk to swimmy
(Swimmy) Hi Dave, what is it?
(You) I lost my magic powers this morning.
(Swimmy) Oh no!
He pauses and looks something up on his computer.
(Swimmy) Apparently you can get them back, you just need to find 4 magic crystals! Maybe you can find them. Look around!

[Scene 'Getting Acquainted' ends]

>scenes
Scene 'Entire Game' playing (for 8 mins now)
Scene 'Getting Acquainted' ended
(Scene monitoring now switched on. Type "scenes off" to switch it off again.)

>scenes off
(Scene monitoring now switched off. Type "scenes" to switch it on again.)

>s
Hallway Outside Room 202
You are in a hallway. To your north is a door labeled "Swimmy's Room", Room 202, and to your west there is a hallway.

* * *

>w
Elevator Floor 2
You are in an elevator room. The elevator can go up or down. To your east is a hallway.

>up
Elevator Floor 3
You are in an elevator room. The elevator can go down but not up. To your west is a door labeled "Kitchen and Pool", and to your east is a door labeled "Dining Room and Rooms".

>e
Hallway Outside Room 300
You are in a hallway. To your north is a door labeled "Tiggery's Room", Room 300, and to your east there is a hallway, to your west is an elevator, and to your south is the dining room.

* * *

>n
(first opening Orca's door)
It seems to be locked.

>break door
Ummm... you'll get kicked out of SPICH for that.

* * *

>s
(first opening Dave's door)

Hallway Outside Dave's Room
You are in a hallway. To your north is a door labeled "Dave's room", Room 201, and to your east and west the hallway continues.

>scenes
Scene 'Entire Game' playing (for 1 mins now)
Scene 'Getting Acquainted' playing (for 1 mins now)
(Scene monitoring now switched on. Type "scenes off" to switch it off again.)

>w
Hallway Outside Room 200
You are in a hallway. To your north is a door labeled "Sylvia's room", Room 200, and to your east there is a hallway, and to your west there is an elevator.

* * *

>n
Sylvia's Room
You are in a pink bedroom with a bed and a closet, and an oven that smells like chocolate cake. To your south is the exit.

Sylvia is snoring loudly on the bed.

>s
Hallway Outside Room 200
You are in a hallway. To your north is a door labeled "Sylvia's room", Room 200, and to your east there is a hallway, and to your west there is an elevator.

* * *

>e
Hallway Outside Room 202
You are in a hallway. To your north is a door labeled "Swimmy's Room", Room 202, and to your west there is a hallway.

>n
Swimmy's Room
You are in a bedroom with ocean wallpaper, a bed, a couch, and a bunch of tools on top of a desk.

Swimmy is sitting on the couch reading a book.

>talk to swimmy
(Swimmy) Hi Dave, what is it?
(You) I lost my magic powers this morning.
(Swimmy) Oh no!
He pauses and looks something up on his computer.
(Swimmy) Apparently you can get them back, you just need to find 4 magic crystals! Maybe you can find them. Look around!

[Scene 'Getting Acquainted' ends]

>s
Hallway Outside Room 202
You are in a hallway. To your north is a door labeled "Swimmy's Room", Room 202, and to your west there is a hallway.

* * *

>w
Elevator Floor 2
You are in an elevator room. The elevator can go up or down. To your east is a hallway.

>down
Elevator Floor 1
You are in an elevator room. The elevator can go up. To your east is a hallway, and to your west is a door labeled "Commons".

* * *

>w
Elevator Floor 2
You are in an elevator room. The elevator can go up or down. To your east is a hallway.

I beg your pardon?

>north
You can't go that way.

>up
Elevator Floor 3
You are in an elevator room. The elevator can go down but not up. To your south is a door labeled "Pool", and to your east is a door labeled "Dining Room and Rooms".

>south
Outdoor Balcony
A large balcony. To the east is the Dining Room, and to the North is the Elevator.

You can see a Pool here.

>go in pool
That's not something you can enter.

>inside
You can't go that way.

>take pool
That's fixed in place.

>look at pool
The sun reflects off the water, and you can see something floating on the water. It appears to be a giraffe floatie.

* * *

>down
Elevator Floor 2
You are in an elevator room. The elevator can go up or down. To your east is a hallway.

>d.
Elevator Floor 1
You are in an elevator room. The elevator can go up but not down. To your east is a hallway, and to your south is a door labeled "Commons".

>w
You can't go that way.

* * *

>n
(first opening Little Giraffe's door)

Little Giraffe's Room
You are in a bedroom with grassy wallpaper, a bed, a couch, a desk, and a bunch of books on top of a shelf.

Little Giraffe is sitting on the couch watching TV.

>give floatie
(to Little Giraffe)
Little Giraffe doesn't seem interested.

 Little Giraffe cheers at something on the TV.

>talk to little giraffe
(Little Giraffe) What is it, Dave? Did you bring me candy?
(You) No, but I lost my powers this morning...
(Little Giraffe) Maybe I have something that will help. If you find my pool floatie I will give you one of my special toys!
(You) Ok, I will find it!.

>give floatie
(to Little Giraffe)
(Little Giraffe) Thanks! Where was it?
(You) It was at the pool, obviously.
(Little Giraffe) Oh. Well, you can have this pogo stick!

* * *

>e
Hallway Outside Room 300
You are in a hallway. To your north is a door labeled "Tiggery's Room", Room 300, and to your east there is a hallway, to your west is an elevator, and to your south is the dining room.

>no
That was a rhetorical question.

>north
(first opening Tiggery's door)

Tiggery's Room
You are in a bedroom with orange striped wallpaper, a bed, a couch, a desk, and tools hanging on the wall.

Tiggery is making something with his tools.

>talk
(to Tiggery)
(Tiggery) What's going on, Dave?
(You) I lost my powers this morning!
(Tiggery) That's not good! Swimmy probably already told you, but you need apparently 4 magic crystals.
(You) I know!
(Tiggery) Anyway, I don't have anything to help you with, sorry. If you could bring me some sushi that would be good though!

* * *

>s
Hallway Outside Room 300
You are in a hallway. To your north is a door labeled "Tiggery's Room", Room 300, and to your east there is a hallway, to your west is an elevator, and to your south is the dining room.

>s
Dining Room
You are in a large area with a bunch of round tables.

Orca is sitting at one of the tables.

Fladibearius is sitting at another table.

>talk to orca
(Orca) Swimmy told me what happened, Dave.
(You) Can you help me?
(Orca) What do you need?
(You) Do you have any sushi?
(Orca) Oh! Yes, here you go. Bye Dave!

>talk to fladibearius
(Fladibearius) Hi Dave, I heard about what happened. I can't really help you.
(You) That's fine Fladibearius. What are you eating?
(Fladibearius) This is honey cake. Do you want any?
(Yes or No)

>Yes
(Fladibearius) Here you are!

>i
You are carrying:
  Honey Cake
  Sushi

>n
Hallway Outside Room 300
You are in a hallway. To your north is a door labeled "Tiggery's Room", Room 300, and to your east there is a hallway, to your west is an elevator, and to your south is the dining room.

* * *

>n
Tiggery's Room
You are in a bedroom with orange striped wallpaper, a bed, a couch, a desk, and tools hanging on the wall.

Tiggery is making something with his tools.

>talk to tiggery
(Tiggery) Sushi is the best! You can probably find some in the Dining Room.

>give sushi to tiggery
(Tiggery) Oh wow! Thank you!
(Tiggery) I just realized, I can give you this CD. I don't know why you would want it, but here you go!

>i
You are carrying:
  CD
  Honey Cake

* * *

>w
Hallway Outside Room 200
You are in a hallway. To your north is a door labeled "Sylvia's room", Room 200, and to your east there is a hallway, and to your west there is an elevator.

>n
(first opening Sylvia's door)

Sylvia's Room
You are in a pink bedroom with a bed and a closet, and an oven that smells like chocolate cake. To your south is the exit.

Sylvia is snoring loudly on the bed.

>break door
Violence isn't the answer to this one.

>hack door
That's not a verb I recognise.

>destroy door
Violence isn't the answer to this one.

* * *

>wake sylvia
Sylvia wakes up.
(Sylvia) What is going on???
(You) I lost all of my powers! Do you have a magic crystal?
(Sylvia) Yes, but I will give you one only if you bring me chocolate.

Sylvia fell asleep again.

>d
You can't go that way.

Sylvia fell asleep again.

>d
You can't go that way.

>look
Sylvia's Room
You are in a pink bedroom with a bed and a closet, and an oven that smells like chocolate cake. To your south is the exit.

Sylvia is yet again asleep.

>look
Sylvia's Room
You are in a pink bedroom with a bed and a closet, and an oven that smells like chocolate cake. To your south is the exit.

Sylvia is yet again asleep.

>wake up sylvia
(Sylvia) STOP IT DAVE!!!

* * *

>wake sylvia
Sylvia wakes up.
(Sylvia) What is going on???
(You) I lost all of my powers! Do you have a magic crystal?
(Sylvia) Yes, but I will give you one only if you bring me chocolate.

Sylvia fell asleep again.

>look
Sylvia's Room
You are in a pink bedroom with a bed and a closet, and an oven that smells like chocolate cake. To your south is the exit.

Sylvia is yet again asleep.

>wake sylvia
(Sylvia) STOP IT DAVE!!!

* * *

>look
Sylvia's Room
You are in a pink bedroom with a bed and a closet, and an oven that smells like chocolate cake. To your south is the exit.

Sylvia is trying to fall asleep.

>wake sylvia
(Sylvia) Shhhhh. I am trying to go to sleep Dave.

>talk to sylvia
She is fast asleep, dreaming about fancy chocolate and dancing.

Sylvia fell asleep again.

* * *

>w
Hallway Outside Room 200
You are in a hallway. To your north is a door labeled "Sylvia's room", Room 200, and to your east there is a hallway, and to your west there is an elevator.

>north
(first opening Sylvia's door)
It seems to be locked.

>attack door
Ummm... you'll get kicked out of SPICH for that.

>purloin pink magic crystal
[Purloined.]

>i
You are carrying:
  Pink Magic Crystal

* * *

>w
Elevator Floor 2
You are in an elevator room. The elevator can go up or down. To your east is a hallway.

>e
Hallway Outside Room 200
You are in a hallway. To your north is a door labeled "Sylvia's room", Room 200, and to your east there is a hallway, and to your west there is an elevator.

* * *

>w
Elevator Floor 2
You are in an elevator room. The elevator can go up or down. To your east is a hallway.

>up
Hmm... maybe I should go talk to some people before I leave.

>down
Hmm... maybe I should go talk to some people before I leave.

* * *

>talk to swimmy
(Swimmy) Hi Dave, what is it?
(You) I lost my magic powers this morning.
(Swimmy) Oh no!
He pauses and looks something up on his computer.
(Swimmy) Apparently you can get them back, you just need to find 4 magic crystals! Maybe you can find them. Look around!

>look at swimmy
(Swimmy) Hi Dave!

>talk to swimmy
(Swimmy) Good luck Dave!

>examine swimmy
(Swimmy) Hi Dave!

>s
Hallway Outside Room 202
You are in a hallway. To your north is a door labeled "Swimmy's Room", Room 202, and to your west there is a hallway.

* * *

>w
Hallway Outside Room 200
You are in a hallway. To your north is a door labeled "Sylvia's room", Room 200, and to your east there is a hallway, and to your west there is an elevator.

>w
Elevator
You are in an elevator room. The elevator can go up or down. To your east is a hallway.

>up
Hmm... maybe I should go talk to some people before I leave.

* * *

>down
Hmm... maybe I should go talk to some people before I leave.

>x elevator
You can't see any such thing.

>x
What do you want to examine?

>d
You see nothing unexpected in that direction.

>xw
That's not a verb I recognise.

>x
What do you want to examine?

I beg your pardon?

>w
You see nothing unexpected in that direction.

>x
What do you want to examine?

>e
You see nothing unexpected in that direction.

>x
What do you want to examine?

>n
You see nothing unexpected in that direction.

* * *

>up
Hmm... maybe I should go talk to some people before I leave.

>e
Hallway Outside Room 200
You are in a hallway. To your north is a door labeled "Sylvia's room", Room 200, and to your east there is a hallway, and to your west there is an elevator.

>n
Sylvia's Room
You are in a pink bedroom with a bed and a closet, and an oven that smells like chocolate cake. To your south is the exit.

Sylvia is snoring loudly on the bed.

* * *

>look at sylvia
Upon closer examination, Sylvia seems to be dreaming about chocolate cake.

>s
Hallway Outside Room 200
You are in a hallway. To your north is a door labeled "Sylvia's room", Room 200, and to your east there is a hallway, and to your west there is an elevator.

>w
Elevator
You are in an elevator room. The elevator can go up or down. To your east is a hallway.

>e
Hallway Outside Room 200
You are in a hallway. To your north is a door labeled "Sylvia's room", Room 200, and to your east there is a hallway, and to your west there is an elevator.

* * *

>n
Swimmy's Room
You are in a bedroom with ocean wallpaper, a bed, a couch, and a bunch of tools on top of a desk.

Swimmy is sitting on the couch reading a book.

>talk to swimmy
(Swimmy) Hi Dave, what is it?
(You) I lost my magic powers this morning.
(Swimmy) Oh no!
Swimmy pauses and looks something up on his computer.
(Swimmy) Apparently you can get them back, you just need to find 4 magic crystals! Maybe you can find them. Look around!

>talk to swimmy
(Swimmy) Good luck Dave!

* * *

You wake up in the morning and you are in your bedroom, but your magic powers are gone! Uh Oh...

Rainbow Dave's Journey
An Interactive Fiction by Liam Calahan
Release 1 / Serial number 220224 / Inform 7 build 6M62 (I6/v6.34 lib 6/12N) SD

Dave's Bedroom
You are in a small bedroom with a bed and a closet. To your south is the exit.

You can see a Closet (closed) here.

>scenes
Scene 'Entire Game' playing (for 0 mins now)
Scene 'Getting Acquainted' playing (for 0 mins now)
(Scene monitoring now switched on. Type "scenes off" to switch it off again.)

>s
Hallway Outside Dave's Room
You are in a hallway. To your north is a door labeled "Dave's room", Room 201, and to your east and west the hallway continues.

* * *

You wake up in the morning and you are in your bedroom, but your magic powers are gone! Uh Oh...

Rainbow Dave's Journey
An Interactive Fiction by Liam Calahan
Release 1 / Serial number 220224 / Inform 7 build 6M62 (I6/v6.34 lib 6/12N) SD

Dave's Bedroom
You are in a small bedroom with a bed and a closet. To your south is the exit.

You can see a Closet (closed) here.

>south
(first opening Dave's door)

Hallway Outside Dave's Room
You are in a hallway. To your north is a door labeled "Dave's room", Room 201, and to your east and west the hallway continues.

>ea
That's not a verb I recognise.

>e
Hallway Outside Room 202
You are in a hallway. To your north is a door labeled "Swimmy's Room", Room 202, and to your west there is a hallway.

* * *

>w
Elevator Floor 2
You are in an elevator room. The elevator can go up or down. To your east is a hallway.

>north
You can't go that way.

* * *

>up
Elevator Floor 3
You are in an elevator room. The elevator can go down but not up. To your south is a door labeled "Pool", and to your east is a door labeled "Dining Room and Rooms".

>s
Outdoor_Pool_Room
A large outdoor pool. To the east is the Dining Room, and to the North is the Elevator.

On the Pool is Floatie.

* * *

>south
(first opening Dave's door)

Hallway Outside Dave's Room
You are in a hallway. To your north is a door labeled "Dave's room", Room 201, and to your east and west the hallway continues.

>w
Hallway Outside Room 200
You are in a hallway. To your north is a door labeled "Sylvia's room", Room 200, and to your east there is a hallway, and to your west there is an elevator.

* * *

>n
(first opening Sylvia's door)
It seems to be locked.

>eas
That's not a verb I recognise.

>te
That's not a verb I recognise.

>e
Hallway Outside Dave's Room
You are in a hallway. To your north is a door labeled "Dave's room", Room 201, and to your east and west the hallway continues.

* * *

>e
Hallway Outside Room 202
You are in a hallway. To your north is a door labeled "Swimmy's Room", Room 202, and to your west there is a hallway.

>north
(first opening Swimmy's door)

Swimmy's Room
You are in a bedroom with ocean wallpaper, a bed, a couch, and a bunch of tools on top of a desk.

Swimmy is sitting on the couch reading a book.

>talk
(to Swimmy)
(Swimmy) Hi Dave, what is it?
(You) I lost my magic powers this morning.
(Swimmy) Oh no!
He pauses and looks something up on his computer.
(Swimmy) Apparently you can get them back, you just need to find 4 magic crystals! Maybe you can find them. Look around!

* * *

>s
Outdoor Poolroom
A large outdoor pool. To the east is the Dining Room, and to the North is the Elevator.

>take floatie
Taken.

>north
Elevator Floor 3
You are in an elevator room. The elevator can go down but not up. To your south is a door labeled "Pool", and to your east is a door labeled "Dining Room and Rooms".

>down
Elevator Floor 2
You are in an elevator room. The elevator can go up or down. To your east is a hallway.

* * *

>e
Hallway Outside Room 101
You are in a hallway. To your north is a door labeled "Little Giraffe's Room", Room 101, and to your east and west there is more hallway.

>north
(first opening Little Giraffe's door)

Little Giraffe's Room
You are in a bedroom with grassy wallpaper, a bed, a couch, a desk, and a bunch of books on top of a shelf.

Little Giraffe is sitting on the couch watching TV.

>tal
That's not a verb I recognise.

>talk
(to Little Giraffe)
(Little Giraffe) What is it, Dave? Did you bring me candy?
(You) No, but I lost my powers this morning...
(Little Giraffe) Maybe I have something that will help. If you find my pool floatie I will give you one of my special toys!
(You) Ok, I will find it!.

>give floatie
(to Little Giraffe)
(Little Giraffe) Thanks! Where was it?
(You) It was at the pool, obviously.
(Little Giraffe) Oh. Well, you can have this pogo stick!

 Little Giraffe cheers at something on the TV.

>i
You are carrying:
  Pogo Stick

* * *

You wake up in the morning and you are in your bedroom, but your magic powers are gone! Uh Oh...

Rainbow Dave's Journey
An Interactive Fiction by Liam Calahan
Release 1 / Serial number 220224 / Inform 7 build 6M62 (I6/v6.34 lib 6/12N) SD

Dave's Bedroom
You are in a small bedroom with a bed and a closet. To your south is the exit.

You can see a Closet (closed) here.

>u
You can't go that way.

>up
You can't go that way.

>down
You can't go that way.

>s
(first opening Dave's door)

Hallway Outside Dave's Room
You are in a hallway. To your north is a door labeled "Dave's room", Room 201, and to your east and west the hallway continues.

* * *

You wake up in the morning and you are in your bedroom, but your magic powers are gone! Uh Oh...

Rainbow Dave's Journey
An Interactive Fiction by Liam Calahan
Release 1 / Serial number 220224 / Inform 7 build 6M62 (I6/v6.34 lib 6/12N) SD

Dave's Bedroom
You are in a small bedroom with a bed and a closet. To your south is the exit.

You can see a Closet (closed) here.

>use closet
You can't use the Closet right now.

>s
(first opening Dave's door)

Hallway Outside Dave's Room
You are in a hallway. To your north is a door labeled "Dave's room", Room 201, and to your east and west the hallway continues.

* * *

>e
Lower East Bukshelv Cliff
You are at the base of the most enormous cliff imaginable. It is so steep, how on earth can you get up there? The base of the cliff stretches on to your west.

>w
Lower Central Bukshelv Cliff
You are at the base of the most enormous cliff imaginable. It is so steep, how on earth can you get up there? The base of the cliff stretches on to your east and west, to your south is the Plains of Car Pet.

* * *

>e
Hills of Kauch
You are on some navy blue hills, with the Kauch River flowing through, and to your east is a view that seems to go on forever. To your west is the South Plains of Car Pet.

>look at river
(Kauch River)
The Kauch River stretches across, flowing quickly down towards the base of Bukshelv Cliff.

>purloin bucket
(Bucket)
[Purloined.]

>use buckt
You can't see any such thing.

>use bucket
(Bucket)
You fill the Bucket with water from the river.

>i
You are carrying:
  Bucket of River Water

* * *

>s
(first opening Dave's door)

Hallway Outside Dave's Room
You are in a hallway. To your north is a door labeled "Dave's room", Room 201, and to your east and west the hallway continues.

>use hallway
You can't see any such thing.

>use door
You can't use Dave's door right now.

>salkdfj
That's not a verb I recognise.

>asfjoa
That's not a verb I recognise.

>f
That's not a verb I recognise.

I beg your pardon?

* * *

>e
Hallway Outside Room 202
You are in a hallway. To your north is a door labeled "Swimmy's Room", Room 202, and to your west there is a hallway.

>f
That's not a verb I recognise.

>ie
That's not a verb I recognise.

>fjiv
That's not a verb I recognise.

>die
That's not a verb I recognise.

>ei
That's not a verb I recognise.

>v
That's not a verb I recognise.

>is
That's not a verb I recognise.

>s
You can't go that way.

>e
You can't go that way.

>gow
That's not a verb I recognise.

I beg your pardon?

>fofkqo
That's not a verb I recognise.

>w
Hallway Outside Dave's Room
You are in a hallway. To your north is a door labeled "Dave's room", Room 201, and to your east and west the hallway continues.

* * *

I beg your pardon?

>f
That's not a verb I recognise.

>f
That's not a verb I recognise.

>ss
That's not a verb I recognise.

>s
You can't go that way.

>n
Dave's Bedroom
You are in a small bedroom with a bed and a closet. To your south is the exit.

You can see a Closet (closed) here.

>se
You can't go that way.

>s
Hallway Outside Dave's Room
You are in a hallway. To your north is a door labeled "Dave's room", Room 201, and to your east and west the hallway continues.

* * *

>e
Hallway Outside Room 202
You are in a hallway. To your north is a door labeled "Swimmy's Room", Room 202, and to your west there is a hallway.

>d
You can't go that way.

>s
You can't go that way.

>w
Hallway Outside Dave's Room
You are in a hallway. To your north is a door labeled "Dave's room", Room 201, and to your east and west the hallway continues.

* * *

I beg your pardon?

>s
You can't go that way.

* * *

>w
Hallway Outside Room 200
You are in a hallway. To your north is a door labeled "Sylvia's room", Room 200, and to your east there is a hallway, and to your west there is an elevator.

>s
You can't go that way.

* * *

You wake up in the morning and you are in your bedroom, but your magic powers are gone! Uh Oh...

Rainbow Dave's Journey
An Interactive Fiction by Liam Calahan
Release 1 / Serial number 220224 / Inform 7 build 6M62 (I6/v6.34 lib 6/12N) SD

Dave's Bedroom
You are in a small bedroom with a bed and a closet. To your south is the exit.

You can see a Closet (closed) here.

>z
Time passes.

>z
Time passes.

>wait
Time passes.

>scenes
Scene 'Entire Game' playing (for 8 mins now)
Scene 'Getting Acquainted' playing (for 8 mins now)
(Scene monitoring now switched on. Type "scenes off" to switch it off again.)

>z
Time passes.

>zz
That's not a verb I recognise.

>z
Time passes.

* * *

>zz
That's not a verb I recognise.

>scenes
Scene 'Entire Game' playing (for 19 mins now)
Scene 'Getting Acquainted' playing (for 19 mins now)
(Scene monitoring now switched on. Type "scenes off" to switch it off again.)

>restart
Are you sure you want to restart?

>yes
You wake up in the morning and you are in your bedroom, but your magic powers are gone! Uh Oh...

Rainbow Dave's Journey
An Interactive Fiction by Liam Calahan
Release 1 / Serial number 220222 / Inform 7 build 6M62 (I6/v6.34 lib 6/12N) SD

Dave's Bedroom
You are in a small bedroom with a bed and a closet. To your south is the exit.

You can see a Closet (closed) here.